   #  #        ##  # ###   #   #      #       ###  #   #   ##     #  # ##  #  #      #           # #  # # ##      # #  # # #
 S#     ##     #     ##       # #            ##   ##    ##    # ##  #       #     ## ### # #    ##   #      #      #      # 
  #       #   #    # ##  #       ##     #    #   #  #               ##    #        #  #   ##        # #    # # #  # #   ## #
 #   #    #   # #  #  #     #     ###   ###    ##      #     ##       # #     #          # #    #     # # ######       ##  
# ##  ## #  ##  ### #       #   ##   #    # ###    #   ##  #      # ####    ##  # #   ## ##  # ##     #       ### ##   #    
  ##     #      #     #   # #  #             #    ## ##  ###           ##  #   #   #   #      #  ##  ##  ##    # ## #       
#       #    #    #     # # # #  # #          # ##  ## ## ###   ## #    #  #    ##      # #          # # E   #    # ###  #  
           #     # # #  #       #  #           # ##  #   ####   #  #  ## #  # #           #      #     #   ###  #     ##    
  #  #      #  #    #   #  # #     #      #        # # #   #    #   #    ##   #    ##   #   # #    ### #  #  #      #####  
  ## ###   # # # ## #   ## ##   #            #      ##   # #     ### #     ##  # # #    # ##   #  #        # ## # #     ## #
###           ##           #    # #  #   #  ##      #          ###    ###   #   # #  ##             # #   ###   #    #     
  ##      #    ###  # # #    #    #       ###    ##   #  ##          ## # #  ##   #    ##    #  # #  ### #  ####      # #   
 # ## #       #  #   #   #            #    #  # ##    # ## ##  # #   #  # #          ######     ##    # #  ####    # #   ## 
  ###  # # ##   ####  #    # #    #  #  # ###      #   ##   ###   # # ##     #       #      # # # # ####     ## # #  #  ### 
  #     # #    #   ## # #    ##   # #  # #  #    # #   #  #   #  # #   #  #     #   ### ##     # #  #  #  #  #  #  #        
     # ####  # # #  #     # # #  ## #   #         #   # # ##   #    #       #  #    #####  #  ###    #   #   #      #   #   
 #  #     #### # ## # # ###    ##      #        ####      # ##  ##  # #  #    ##     #  # ## #  #  # # # # # ## #           
# #     #  ### #     #    #     ##      #     #   #     u #     ## #   # #  ##### #  # #      # #     ##   # #    ##       #
  # ##   # #  #### ###    ## # ###   # ##   ##   #   # # ##       #     #   #       ## ## #   ##        # ##         #      
      ##              #   # #      #      ##       ## #              # # #      #          #    #  ###    #       # ### ##  
#  #        ##               #     ####     #  #     ##  # #    ##  ##  #      ##    ###       #  ###  # #  #         #   ##
  # #     #    # ### ##        # #     #       ##      ###  ##   #           #       # #       #   ##        ##  ###   ##  
   #    ##  # ##    #  # ### #  #    ##    # ####       ##  ###    # #        # # # #  # # ##        # ##    #        #     
     #    #  ##  # #     ### # ##    #    #  ## #  # #  # #       #  #  # #  ##              #               ##    ###  #   
     #  #     #   ## #        #   ### #  # #  # ##  #  # ###  ###  # ##      #   ##    ##          #  ##  ##  #   ##    ##  
#    #      ## #  ###   # #          ##   ###i #   #   ## ###  # #  #  ## # # ### #     #         ####  #  #     # # ## ##   
   # ## # #  #  #   ###  #          ##    # #        #   #  # #   # #  #   ##       #     ##    #  # #       ##  ##    ##   
    ### #### #    #   #       #  #         #     ##    #  ##        ##      ##       ## #  # ## #  # #       #    #       # 
#         ### #     #   # #  #         #  #     #  #   #  #     # #   ##   #          ##  ##      # ##            ##    # # 
# #   #   # ##   #    ###  # # #         #     # #       # #  #    ### # # #  # # ##     # #    ## #   ##   # # ##  ####    
    #   # #  # # #  # ## ##   # # #   #   #  ##   # #      #        #  ##  ##   # #     #       ##      ##   ##   #         
  #  #  #   #    ##   ###  # #      ##   #       #     #  #### #           # #    #  #     #   #           #       #  #     
    #        ##   ## ##  #     ##  # # ## # #       #         #  # # #  ## #        # #  #  ##  ## ## #     ##  #   # #  # #
##   #  # #      #  ##      #    #  #  ## ## #  #   # # # # # #   #  #  ##  #  ##    #            #       #  #     # #   #  
 # ## ##   #  #   # #      #     #     #       #   ####     #       # #     #    ###   # #   #    ##  #  # ##    ##  #   #  
#  #    #     #     #  ####  # #    ## #  #   ##   #    #          #        #           #  ###  ##    # ## ## ## #   #    # 
         ## ## ## #   ## #      #          ### ##   # ##  ######  ##     #     ##  # # #       #   #   #     ## # #####     
  ##  #  #    # # #      #       ###   #  #    # ###  ##  #      #####   #  # # #  #   #        ### #    #  #      ##    #  
 #  ### #  #   #  #       #  ##      #      #            #        #       #   #   ##   #     ###  #  #       # ##           
 #    #       ##        #   ## #           # ###    # #   #   ##   #     #####  #           ## # # #             #      ## #
#   #####  #  # #  #   #   ###    #     #  ### ##   #   #  ## ## #  #  ##  #   # # #  #  #  ## #        #   # #   #         
    #                  #   #  #   #      # #    ####### #  # # #  ###  #        ##    #   #    #    # ##  ### ##   #  #     
      ####               ###  # ## #  # # #   # ##   #  #  # #            #  ##    # #  #  ##   #  #        ##  ##     #   #
  # # # #       #  #  #  ## # # ##  #   ##   # #  #  ###  ##  #    # #   #     # #  # # # #  #   ###    ##### #        ##  #
  #         #    #   #    #        #      #   ## #    # #  #         #         #         #     #    # #   ###   ## ### #  # 
#  #       #              #  #   # #  #    ##  #   #      #  #    #   ##  ## # #  #   #            # #   #      #      #  # 
     # # # #  ##  #    # #               ##   # # ##  ##   # ###  # #    ##  ##           #   #   #  #  #   #      #       #
   ###       #    # #  #  #  #   # #   # ##   ## ###  ##      ###   #      ##      #  #   ## ##  #       # ## #   ##   #  # 
# #        #  ##    #     #   # #   ### # ##  # ###        ## ##  ## ### # # #   # # #  # # #   #  #      #  ##    #    ### 
 # #  #   #  #    #    #   #  #  #   #         #    # # # #    ## #  ##  ##   ##     #  #          #    #    # ##  #     # #
 ##   ##        ## #  ####   # #   #   # ####    ## # ##   ##  # #   ##  #   ##    #  ##   #          #        #   ### #  # 
   # ### #    ##  #     #  #   #  # ### ##   ###  #   # #  #   ## #  i  # #      #    ## ### #      ##  # #     #  ## # #    
 #   #  #  ##     # #    #    #     # # #  #   #   #  #    ##      # # ##  #   ###   #     #    #  #       #    ### # #     
     #      # ## #    # #   # ##   ##          #      #        #      #   # # ##  #           ##     # #    #   #  ##   ## #
##     #         ###        #    #     ##   #  #   # #    #    ##  #    ##     #    #####   ## ##    ##   #        ##  ##  #
  #    # #      # # #     # #     #      #  #       #   #              # #      #  #   #  #   #  # # ##  # #     #     # ###
  #  #  #                    #      #   ###  # #    #### ##     ##    #   #      ##    ##  #  #   ## #     ###  #    #     #
    # #### ###  #   # ## #   ## #  #       ##   # ##  ##    #  #  ## #     #   # ##             #          #    ###     #  #
   ###      ### #  ##   # #      #  ###  #  #    # ##        #    ##  # ##   ## #       # #   ###  #          # ## #        
      #  ##     ###  #     #         ###     ###     #     #   # # #           ### #  ###     # ###       ##    #  ##     # 
 #                #  ## #        #  # ##        # #  ##  #    #    # #     #  #   #  ##    ###     #   #    #    # # # ##  #
        #  ##  ###    # ### #      #            #           ##    # #                       # #      ##       #   ## #   #  
  # # ## # # # ##  #  #   #    #       #    #   #  #  #    #         # # ##  #             ##  #   ####       ### #    # ## 
 #    ##           #    # #  # # ##     #  # #   #    ## # ##    ## #   #  # ##   #     #  #      #        # #    #  # # #  
 #    ## #      #       ### #  #        #       ####  #####  #       ##   #      #  ###            # # ## #  #    # # #     
 ###   #  #      #    #   i##   #    #   # #   # #   # ## #      ###   #   # ## #  ##       # ##  #   #   #   #### ## #   #  
   ## ##     #     #    #       ##        # ###      #### #  # # #  #     # #    ## #  #       #     ## #        #     #  # 
##        #  ### #  #    # #          ##   # #  #   ####  #   #  #    ### #####  ##    # #   #   #  #   #     #        # #  
## #  # ##  ### #  ##         #  # #  #    #         #     # #          #  ###  ## ###      #    #      ##  #     ##  #  ## 
     # #   ### #    # ###   # #     ######    #      #   #   # #   #   ##    ## ###     #      #    # ## ##  ##    #  # ##  
##       ## #   ## #  # #    #      #    #        # #   #     ##    # # #    ##  #      # ##  #      #   # # #    ##      ##
 ##        # # ## #  #        #  # #  #  # #  #  #    #   #        ##  #     #   ### # ##   #   ##   #  #  # #  #   ##      
       #          #  #        # #  ####   #   #     #  # ## #     # #          ## #        # ## #       #   #     #      #  
     #        #  #    ###  #  #   ###   #     #     # #  #          ##        #      #    # #     #         ## #   #  #  #  
         # #  #    ##  ##    ##   #  #   ## #      ## # #   #    # #    #  ##  # ##              ##        #   #   #   #    
       #  # ###         #   ## #       # #   #  #        ##  ##    #      #  ##  #   #  #    #      # ######          ## #  
    ##  #      #  #         ###  #  # #           #   # #   ## # ##       #   #         ## #   #   # ## ##   #  ##     #  ##
  #  ##  #        ####   #  ## ####     #     #   #   ## # # #  #  #  #    #  # ## #         ## #       #   # ###  #####  # 
      #  #  #     #     #  # #      #   ##   #   #   ## #     #### ##     #     #  # # #   ##  ###    ##  # ##    #   ## #  
##  ##    #  ## #  ##  ##     ## #    ##      ##   # ##   #  ###     #    o     #     #     ##        # #   ##   # # #  # #  
    #     ## ##   #     #                     ####     ##      # #   #  ##  #     # ##  #    #     ## # ##  ### # #         
# # #  ##  # #  #  # #     ###      ##    o##  ### #  #    ##      ## ##          #  #      ##     #  ##  #### #  #  ## #  ##
 #####          #     # # #             #  # ##      # #      ## ##      #     # # ##     # #  #   ##   # ##   # #  #       
  ##  ##   # #  #    #    ## ##       #     # #   #  #  ##             # ##      #   #  #         #####        #    # # #   
          ##  # #     #   #           #    #     ###    #      #  #  # #   ## #      ##  #      #          ##  ###  #   #  #
     #   ##    ##     #  #  #   ###  ####    ##          # ##  #    # #    ##         #     #     ##  # #  #      #        #
    #   #  #  #     ## #   ##  #  #     # #           #   #  #    # #  # ## # #   #         #  # #     ##   #   # #         
#         #  # # #     ##   #    # #     ## #   #  # ## #    # # ## #  # #    #  #           ##     #  #  #  ##   # #     # 
 #   # #       ### #  #   #    ##    #   #      #             #         #   #  #   #   #      #    ## #   #  # #   #        
    #    # # #    ### #     ## ##   #   #    ##      #    #    ###  #   ##         #     #   ## #  #            ##  #   ##  
#  #  #  # # #  ###   #         ##     ######     # ## # # ##  ####      #  ###        ##            #     # #      ##    ##
 #  # #   ##  #      ## # #       #       ## ## #   #         #   #    #   #   #          ##  # #     #      ###    #  #    
  ####    #     #     #  ##   # ##    #   ##  ##   #  ##  ###  #           ##        # ##      #    ###  #   #     #   # # #
   ##  #       # #     ####  ## #  # #  ##       #  ##  #  #      ##    #  #       #      ###  #       ##  # #   # #     ## 
##   # ##     #     #  # #   #p#  #   #   ### # # #  ## ####   # #  #   #  #  # #  #  #  ## ## #   #   #           #    ###  
### #       #      #  #  #   ##  #  #      #  # #    ### #       #    ## #   ###  #  # #   ###       #  # #   #    #    #   
 # #  # #   #   #   ###   #  # # #    ##       ##          #   #  # #      ## # # #               #   #  # # ## #       #   
#        ##    #   #   ##    #   # ###  #  #      ##  #          ## # ##   #  # #         ### # # #    #     #  #  #       #
