  # # #  #   #    ###     ### #  ##  #   #    # #####        ##   # # #  ## #  ###  #     #  #    #  ##### #             # ## # # ####  ## # # #   #   # #  #   #   # # ##  # #   ##           # 
 S#    #  #  #           #        #  ####    #  #   #      # # #   # #       #          ##     # ##       # ## #   ##     #   # # #    #          #     #  #      # #   #       ##  #        ##  
  #   #            ####  ##  ##          #  #          #  #  #   # ##  #  #  ##   #  #     # #   #   ## # # ###    ##       #   # ##  #  #      #     ##   ###  #   #   #   # #     #     ###    
# ###     ###   ##  #   ###  # # ## # #   #  #     #          # ## #  #   # # # ##         #  # #   # #  #   #   #     #   ##   #   #    #         #    #  #  #    #   #  ## #   ##     #   ##  #
  ##    #  #                #    #     ##       ##      ##      #   #  ## ##    #  # #     #  ###  ## ##  # # #   ##  ## ##    #   #    #    #  #  #  # #   #   #  #   # ###   # #  # #      # ##
       #  ### #   ##   #     # ##  #           # #  #              #        ### # # #        # #   #   #     ##       #    ##       ##   # ## #       #      #     # #    # #      # #     # #  #
    # ## #    #         ####       #  ## ###   ## ##      #     ##      ## ## #      #   ##  # #  #        #        #     #      # #  #  ###         ## #       ## # # #   ###       #  #        
    # #  #            #    ###  #     #         #  #               # ##            ##  ## # #   ##   #  # ## #   ## #    ##   ####  # # #   #    #  #   ### #   # #   # #         # ##  #   #    
 ###    # #  #    #   # # #  #       #   #     #  #  ## # #    ###     # #  #  ## #  #       #     #  #####  #  # #   ####      # ###   #        #### #       ##   ## #        #  ## #    #   ## 
# ##  #  #    #     #  ##   #      #          ###            #      #  #  #     #  # ##    #     #         ##       #        ### ##         ##  #  ## #    #  # ##  ##   ###         ## ## # # # 
   #  #   ### # #        #   #  ## # #   ##    ##    #  # # ## #  #      #  ##### #  # #    # # #  ##         #    #   #    # ##  #         ###    #  # #    #              #####      #      ## 
##  #   ##       # ##  ## #  ##   # # #### ## #   # ##     #   #  #     #  ## #        #       ## # #    ### #       #     #  # ##         ######   # # ##   # #  ## # ####   ##        #  ##    
#      ##   # #            # #   # # #   #    #          #       ##   # #    # # #         # #      #               #     # #       # #        #              # #      #    # #    #  ### #    # 
      ##  ###   #  ### # #  ## ### ##   # # #                   #   ## #    ## ###  ##  ###   #  ## #  ##     ## ## ## # #    ###   ## # ##  ## #   ###  #       #       #   ##    #  #      ## 
  #          #    ##      ###       ###### # ##     ##   #  #    ##    #  ####  #    #       E        ##     #   # # #  ##    ###   ##  ## #  ###   # #    ##    #    #      ##     # ##         
   ##  ## #        #### #   ## #  ##   # ##   #  #       #     ##   ###  #   #       #    ###     #   ##      ###    # #    #   #     #    ## ##    ##  ###      ##    #  # # #  #         # #   
   #  #    #       #    ###         #   #   # #  # #   #       ##    ###  ## #       #   ###        #  ##   #  ## #      ## ####   #     #   ## #       ##      ##           #     #  #          
#       #   #   ### #   # ##   # #       #   # #  ## #     ## # #        ##        ##  ## #  #       ##         #    #  #   #     #  #   ##   #    ##   #    #  #  #    ###  #   #### # ##  # # #
## #  #              # #         # #   ## # ###  #  ###  #    #  # #  # #  # ##      # #   #          # #      #    #    #   # # ## #      ##     # ##   # # #    # ###    # # #    #    # ## # 
    #        #    # # #     # #   #         #  #   #  #   #  #        #    ##    # #    ###    ##   # # ##  # # #    #    # ## # #    ##  #  ##  #     ##  #  #### #   #  #       #  ##### # # # 
#       #  ##  #          #  #  ##  #      #     #  # ## ## #           # # #  # #    #   #  # #  # #   #  #        #  # # # # # #   ####  #    # ##          #       ###  ## #   #    ###  # ## 
       ##    ## # # #  ###          #   ##          # #  # #   ###      #  ## # #      ## # # # #  # ##     ##### ##     ###  #   #### # #     #    ##  #           ##   ##   #  #    # #  #     
 ## # # ## #      # #  # #  #  #         ##  ## # #              #   #### #    #         # ##     #  # #  ###     #             ###        #   #   #  #  ##     # ##     #     ## ## # #    ###  
 #         p   # #    ###    # #  #    #   ## #        #    # # ##   # ##  #      #      #  #   # #  #    # #    #  # # #  ##            #   # ##  ###  #  ## # #          ##### # ##  #      ## #
 #   #   #  # # ##  #   #         # #   #   # # ##      #      # ##  ##   #     # # # #                    # #  #          #  # ## #  ## # # #   # # #   #  ##     ##   ##   #  ##   #   ###   # 
#     #        ##  #    ##  ## #  #  # ####      ###        # ## #  #    #   ## # #  ##        #   #               #    #    #      ####  # ## ####        #     #    ##  ## ### #   # #       # 
   ##    #    # #        #    # ## #  #  ##  ##   #  ##   # ##    #   ### ##   #   #     #  ##  ####   #  ##    #    #   #   #    ### #  # #           #       ##    #   #    #    # #  # ##   ##
 #  # ##   #  #         ##   # # #     #   # # ## ##         # #      # # # #  #   #  #   #  ### # # #   # ## ##   ##    #      ##       #        ##         #    #    #    #  ## # # #   ##     
  #   ###  #      #   #  #         #   ##            #        #   #    #        # #  #   ###   #   ##       #    #  ##     # #  #   ##           #  ##     ##     #   #  #########      #   ## # 
 #  ## ##   #         #     #     #   # #   ##   ####                           #    #  #       ## ##    # #    ###     # #    # #   ####        ## #  # #    ##   #  #       #   #  ######  ##  
       ##   # ## # #          ## #    #  #   #  #  #     #   #       ####    #   #   #  #        #   # #      # ###  #     # #  #  # #    #      #  ### #    #  #    ### #  #     #   #         #
#   #        #  ##            #  ##  #     ##     ## ###   #    ##     #     # #    #####     #  #     #   #   ##      ## ##    #   #        #     #          ##   # #  #      #     # #  #  #   
#   ##    ## ##         # #   ## #     # #       #     #  ##  #   # #    #  #  #  #    ##   #  ## # #    ##   # # #   #    #   ###  #    #      # ##        #  #   #    ###   #      #     #     
       #   #      # #     ##  #  # #      #   ##  #    # # ##      # ##  #   #   #   #   #   # #   ##  #         #     ##   ##        ## #  ##  #  ###      #  # # # #   ## ###  #   #    ## #   
   ##                       # ##       # #   #  ##   ##   #    #    #      #      # #      #      ##   # ##      #         #    # ##   #   # #    #  #    ##  #    # #     # #      #   #   ##  #
   #    #      ##     # #   ### #  ###  ### #        # #       #   #    ## ##       #    ##     #      ##      ## # #   #   #        #  ##        #       #      ### ### #                #  #   
 #    ##   # # #     ##     # #    #  #     #  #  ## #      #   # #  # ##      # #     #      ##  #   ## # # #   #     # #   # ##        #   ##   ## #  #      ##     #  # ##   #  #  ##        #
   #  #         ##  # ## #  #       # # #  #     #    #     #        #     #       ###   #  # #   #   # #   # #   #  #### # #    ###              # #    #     # #  #           #       #    #  #
## #   #   ##     #              #### #   # #        #  #     ####   # # ## #    # ###    #   #      #   #    ###      #    # #    #      #    #    ##    ##  # #      ##  ### ##   #      #     
#  ##   ##         #     #     # ###  #  #   ##     #    #   ## #      ##   # ##  #    ##  ###   ##        ##      #        #   #    #      #          #  #      ##    ## ##   #      ####  #  ##
      #      #  #  #  # # #### #  #    ####    ##    #      ##      ##  ###      #       # # ####      #  #       ##   ###   #        # #  #  #    ###     #     #     #     #     ### ##   #    
           #  #   # #              ##  #   #       #  # # #          #      #       #  #  #  #   ####          #  # #       #  #  #  #    #   ##  ## ### #      ## # ###       # #      # #     #
   ## ##  ## ##  #          ### #  #         # #   # ####  ##              #      ## # #      # # #     #  # ####   #  #       # #   #     #  #      #  ## #       #    ##     ## #  #           
 #  # ## #  #            #     ##  # ## #####    #         ###    # #    ## ####### #          #   # #  ##      # #    ###       #    #  #   # ##     #        #    # #######   #    #           
  # # ##  # #   #   #     # #     #     #  ### #    ##  ##  # # #   #     #        ##     ### ###   # # # #     ##  ##     #   # # #       ## #   ## #   # # #                #### #     #       
##   # ##      #     #   ## #   # #     ##  #      # ##  #  #     #      #  # ##   # #  # #  #     # ##          ##     ###      #  ##  #   ##   ###          #  # ##  ##  #          # #     #  
          #      ### #    #  # #  #  #  #   ##   # #   #    #  #   # #       #   # #   # #   #         #    #  # ##      #   ###   #     #  ###     #     #  #  # # #### ##     #        # # #   
 ## #   ##      # #  # ##    ##     #    #    #        #            ##  #       ##   #   ##    #    # #  #   #   ###  #   ####    # #####  ## # # # #    #     ##       ###       #   ###     #  
## # #       ### #   #  #            #   #          # # ## # # # #  # # ##### ## ##    #    #    #   ## ##  ###      #    #   ##      # ###      #  ### #   ###      #   # #      # ##  # ###  ##
 ##   #  #  ##    #   #    ##    #   ## #  #  ##    # ##      #   # # #    #      #  # # # ##  ## # # # #   #   #   ###  # #  ##  # #    ###     #    # ###  ###    ##   # #           ##  ##    
 ## # ## # ####  # ##    #    #   #   #         ##      #     # #   # #  ##     #   #    #           #  #####  #  ##     ##  ### #  # ####        #    #         # ###  ###  #     # #      #    
  #       # ##   #   ##    # #  #  #  #### # ## ### ### #  ##  #    #   #   # ##   # # # # #  # #    #   #    #    #          #    ###  #       #    #                 #      ##  ##### ###  #  #
  ####   #      #  # ##   # #    # #  ##   # #          #  ##        ## # #   ##          ##  #   #  #  # #   # #   ## ##    #       #  #  ##   #   #             #    #  #  ##  #     #      # #
#      ## # ###   #     #   #   #  #   # # #     ##  #   #  #    #   ##   # # #    ##### ##  # # #     ## #  # ###  # #  #   #     #   #    #        # ##  #  #   #    #      # ##         #    #
##   #  ##      #  #  #         #  #     #     ##    # #     ##   #  ##   #     #    # #    # #     #  ##     #  #  ##     ##     #   # #   # # # # #  ##  #   #     #  #  ## # # ##   #  #     #
#       #     # ### #      #   # ###    # ###   ##  #       #      # #  # #    ## #  #    ###  #   #       ## # #  #   ## ## # #        #  #   #  #       #  # ##     #      #####       #       
# # #    ###            # #  #       #    ##  #   # #  #          #   #  ### #   ## #  # ##                #         #    #  # # #     # ##  # #####       #  # #  # #     #     # #   # #     ##
###    # #   #  ##   #  # # # #        # #    #  #    ####      #     # #        ###     #   #     #        #     #    #     #           # ###  #       #  #  # # ##  #  ####    #             # 
    #  #     ##  #          #      #      ## #             #        #  #           ##  # ## ##  #  #   #   ##      #  #  #     #  # # #   # ###  # # # # #     ##  ### #   ## #### #       ##    
# #      #          ##   # #   #  ##   ##   # ###     # #       #  #   #   ## #  ### ####     #   #    # # # ###  ## ##  ###     # #        ### #          #  # #              #        #   #  # 
 # ## ### #  # #     ##     ##  # ##  ## # # # #        #   ## #  #  # ##   ####       #  # #  # #      #  #  # #  #        ##   #       ##  ##   #  #  #    #   #     #   # #  #  ### #         
  #    #    #  #     #   ##  # ## # #   ##   #         #            ## ##  #### #   #  #   # # #    #   ##        ##      ###    #     #  #  ###  ## #   ##  #       #    #        ##   #        
 ##  #   ##  ## #   #         ###       #    #          #        #   #   ##     #     #  # #      ####   ##     # # ###  # #   #   # #   #   # #     ###      #  ####    # ##    # # #   #     # 
       ## ## ##  ##  #  ## #  ####     #  #  #      #    #       #  ###     #   #   #  # #  #  ##     # #  ###    #    ### #    # ##   # ##    ##  # #    #  #       ###           # #    # #### 
  ##### ##   ### #   # ## #   #  #  #      #            #  #   #   #         ##    #           #  #   # #   #    #        #  #  #    #  #  # #  # ##   # #             #            #  #    ## # 
 # #    #  #  # #   ##  ##  #     ##  ##   #  # # #   # #      # # #    ##  # #       ####  #        #   #    #   #     #                ###     #  #           #  # ##  #        # # #  # # ### 
   #   #  #  # ##     ##   #  # ## #  # ###  ###      # # # # # ##    #  ## # #   #  # # ## ## ###     #       # #   #    # #        #  # #          #   # #    ###   #        #  #      #    ###
 ##  ## #  #      # #      # #      #    #    #          #        #    # #      #  #          #   # #  # # ###  #            ##      #    ##     #     #####  #  # # ###   #   #  ####  ## ## #  
#    #    #     #            ##       # ###  ## # #       ##             #####    #   #  # #      ##          #   #    #  ##        ##    #   # # ##   # # #     ## #   # # #   ## #  ## #  #    
 ##  # ## #     #   #      #  #   #  ##   ##    #   #       # ## ##  ###         #  # #  ## #  ##         # #    #     #           ## #     #  #        ## #  #  #   #       ##   #  #  #    # # 
#       ##   ## ##   #   # #     #      #     # ## #         ###  ### #   #     # # #   ####  ## ## # ## #     #  #             ## #    ##  ####      ## #     # # #   #     #     ## #       #  
 ###     # #  # # #  # #  ## # #            #  ## ##     ##    #  ##    #  # # #        # #   #  # #              #    #   #  # # #  #  ### #             # #     #     ## #            #  #     
 #  #  # #    ###  ## #    #   ##     # ##   #     #    ###     #   # #   #   ###  # # #   # ###       ### ###  ##  ##     # ##    # #     #   #     #    # #     # #  ## # #   #  #  #   #      
## #    #   # # #     # # # #  ##      #         ##  #    ##        #  # #         ###    ##      ##         #     #  ##     #  # #  # # #  ###        ##   ##   # #   #  # #   ##  # #  ##   #  
                ##  #   # # ###  #    ##       #  ##  #    #   ##  ## #    ####       #          # #   #       #  #    #    ##          #  ##   # #     #  #   ##  #    #  #  #    ### # #    #  
   #  #        #  ##    #      ## # ##         # # # #     #        #  #  #   #  #       #    ##  #    #####   #  # #   #   # #     #  #  # # # #  ## # ###      # #### # #       ## ##   # #   #
    # # ###   #       #   ####  ##    #     ##   #     ##  #    # ###    ##    #   #    #  # ###   ##     #   ##  ##        # #           #                  ##   ## #   #       #### ##     #   
 ### #   #  ##        #    #    #     #   # ####              #   ## ## # ##  #               ##   #         # # #             ##  #      #          #   # #          #   #    #  #   ##       # 
     #              # ##     #    ###  # #    #  ## ## # ### #  #        # #   #  #  #  #  ##                 # #     ##        ###  #       ## # #  ##  ##     #    #    #        #   #   #   ##
  #   #       ##  #  #        ## ##   ##        # ###  # #  #  ###         #  #       # #  #       #  ##  ###   # #   ##    #   #     ##    #    #    #  # # #   #   ###       ##   ###    ###  #
 #        ###         ##    #       #        ## ##  #     ###  ##      #  #  ##  #   #    # #            #         #    ### # ###         #  ###    # #  #      #   #   #     #    #      #     #
 #         # ##     #  # # #   # #  #    ## #          #  #     # ## # #    #     #   ##    #    #   #  # ##   #  ##  ## #      #             # ##  #   # # #  #### #    #  #    ##     #    #  #
  ##  #  #       #  # #####     #           #     # # # #  #  #    ##       ##  #  ### ##   #      # #   #     #   #  ##  # ###  ## ##    #     #  #  #      #   #       ###        # # ###      
 # #   ##  ##  #    #  # #  ## ###          #  ####  #     ### #  # #  #      # # ####  ##  ## # #       ##  # #  #   # #        #       # # #     # #      # ##     ### #       # # #    # ###  
#         #  # ##    #     ##  #     #  #  #### # # #    #     ###  ##   ##       ##  #  ##  #      #      ##    #   ## # #### ## #     ### #  ##   ## #   #  #  #    #    # #     #    # #####  
#   #    # ##   ## # #          # #     #  # # #       #         ###### #### #  #  # ##   # #        #   #   # #         ## #     ## # #     # #       # # #          #  # # #     #     #    ## 
  #    # ##      ##  ##    #   ##    #    ####      ##  ####        ##      # #    #    # #    #    ##    ##  #     ##       ##  #        ##       #   ##   ## #  ###   ### #       ##           
  #   # #       # #  # ###      # ##  #    ###  ## #    ###         #  # #  ### #  ##  #  #     #  #  # # #  # #  #           #  #  ## ##  #  # #  # #    # #  #    # ##      # #  #     #   #   
    #  ##   #        # #    #  ###   ##   #            #      #### ## #   # # #  # # #       #      #       ##   ## # # #  ###  #   #   #  # #         ##   #    # # # # ##    #     ###      #  
# ##  #        # #      #   #  ### #  ##   #              # #  ## ###  #  #    # ##   #  ##    #  #  # #   ##           ### #  # #         # #  ##  #  ##  # # # #    #   #  #     #    #    #  #
#       # #   ## #     #  #### #   #       # #   #  ##                     # #   #  # #     ###    # #  ####  # # ##  ##     ##  #   # #  ## ###  #    #  #     # #  #   ##  #   # #          #  
# ###   #    # ## #          #      # ####    # ###           ##  #   #      #  #     ###           ##  # ###  #  #      ###   # #   #  #     ##     #  #         # #     #  # #  #   ##      # #
 #   #    # ##  #   #  #   # #    #       ##     ##       #      ###    ##      #      ## # ###      #   ###        # ##  ##  ###   #  # # #   # #   # #                #   #       ###        # 
#### #       #   ##  # #  ###     #    #     # #  # #       # #      #      ## ####      #    ## #  #   ## #  ## ## #  #  #                ## #   ##           #  ##    #    #   #     # # ##    
     #  ##  ###   #   ##          #   ### # #    #    ##  #    #   ##          #  #          #  # #   ## ##   # # # # #    #   ##     #  #      #   #   #    #  # ##  ### #  #     #   ##  #   ##
  ##    ## # ##   #       #  # #  ###        #  #  ###         #   ##  ##         ####     #  ##  #  #   # ##              # # #  # # #  #  ## #     ## #    # #   ### #  # ##   #      ## # #   
 #   ##### ##       ###     #     #    ##   ###    #  ## ##   #       #  #   #  #   ###     ##    #  #    ## #           #   # #    # ###  ##   ## # ##     # ##             #   #            # #
  ## # #     #     # #                     ##  #      #  ##       #  ## # # #   #      #               ##   #  ##    #     #   #   # #    #   #   # ##    #  ##                # #     # #  #    
#   ## ## #   # #  #   ##   #   ### #   ## #        #   # # #    #  ###   #   ## #  ##       #       ### #     ### #    #   #   #    #      # # ##    # ## #   ##  # # ##   #  ##  ##   #  ##  # 
     #  ##            #     ## #   #       ##  # ##  #  # #      ##   ##     #  ##          ## # ####  ###    ##         #  # ##   ##   #               #      #     # #      #   ## ###  #  #  #
 #  #     #     ## # ##   #  #     #     #      ##                 ##### ##  # # ##     #         ##      #    #    #     #   #         #  #  ##  # ####   ###    # # ##     # # #  # #  ##      
#     #   ## #  ##   # ###     #   ##          # #    #  #    #    #           #  #   #    #        #    #  #    #     #   ##   #    ## # #       #  #    #  #     # #  ##       # ##     #     #
      # # #  #        ##   #       #  ##    #     #  #           #   ##      ##    ##    #           # ##   # #       #  ##    ##    ##       #  # #         #   #        # # #   ##  #  #    ###
#  # ## #  ##      # # #   #      #  #    # #    ###  ##         ## #       ## #   #       #  # #    #          ### ###    # ##   #    ###   # ####   ##   ####        # #   #      ###    ##   #
 ## #      ##  # ## #  ##   ###       # #   #  #     #    ##  #  #        ##        #   #    ##      ##     #   # #   #  #          #   #    #   #   #  #        #   #       # ##  ##          # 
 ## ##            #        # #      # #  ### ##      #        ###   #              # # # #     #    # # #   # # #  #  ##  #    ## ##     #         ##  #  # #   #  #          ## #    ##  # #   #
# #   #        # #   #   ### ##    ###  #  ### ## #   # ###    #  ##   #   #  ## #  #     #  ####         #    #   # #  # ## ## # #  ## #   ##      #  ####      #   #  #     ### # # #   #      
# # #      #  #  ##   #    # #  # #  ##       #      # ####     #  # #   ###    # #      #  ##     # # #  # #  #   ###   # #         #    #        #                 #        ##       #     #   
# #  #        #    ## #     #  # ##   #    #    #     #    ##     #  #   ###           #   # ##  #   #  ##  #    ##      ###            ### #   #         #    # #     # ## #    ## ##  #    #   
 #  # #   ###  ##     #   ##   #  #    # # #  #   ##  #       ##    ## #   ## #  # #     #   #         # #  ##      #  #  # ##    #  ###  # ##    ## # ###   # #  #      # ####       # #    #   
    # ##   #       # # # # #  # #        #   #  # # # ##       #        #     #      ###  #   # ##   # ##  # # #               #  ## # ###    #        # #      #    ###     # #     #    #  # # 
      # ###  #   ### # ## # #    # ## # #            #  ##   #   ###  #### ## ##    #     #   # #     #  #  #  ##   # #  # #  #   # ##     #     # #  #       ## #     # ## ## #                 
#  # #  # # #        #      ##  ##  ## #     ##    ## #  #      # ###  # #           # ##  ###      #          ###   #    ## ###  #    #     ## # #    ## # #       ####         # #     #   #   
   ##     # #    ##  # ###    # # ####   # # ##  #    #           #  #      #    ##               ###     #      #   ##   #  #    ##    #       ## # #          # #    ##  # #   #      # ###  # 
  #     ##     ###    ## #  ##      ## ##     ##  #    # #          #   #   # ## # # ###  #    # ## #           #  ##     ##  #  #   #  ### #  ## #  ## ###   #           #  #     #    ## #   # 
##                ## ##  #       #  ###         ## #     #  ## #    # #  #     #         # #            # #     # #     #    #  #   # #    # #  #  # #     #   # #     ##   #    #         ##    
      # ##           #   #           #   # #   ###  ## #   #  #     #  # ##  #  #  ## #     # ##       ## #  # ###   #        # # ##  #   ## #  # #  #    #     # ## #   # # #  #       ##   ##  
       ##        #   ###   ##   #  #     #   #     #  # ## #   ##     #   #     #  #   ###    #     ## ## ##        ####   #      #  #  ##      # ##    # #    # #    #  #                       
