# ## ##  ## ##      # ##      #        #         # #     #  #     # # # #   ##  #      #  #  #   # ##     ###    #    #      #   #       #   #        ####    #       # ##   # # #  ###              #  
 S#  # # # # ##   # # #### ### #     #  #   ###    #   #         #        ##       #      ###   #   #         ##    #      #  #  ##  ###  #   #    #   ##   # #   ###       # # ## ###          ##     #
 ## # ##    #        # ###  ## #       # # ##                 #### #    #       #   #   # ## ##  ##    #    #  #   # ##      # ##    #  # # #      ###      #   ##   #      #   #   # # #       #   # # 
  ##     # #    #   #  #      #  # ## #        #   ##     ###     ###  #  #   ###    #   #        #  # # #   # #  #   #    # ##   ##  # #  #    #             #             #   # #          #      #  #
  ##  #   ##        #         #          #  # #   # # #   ## #     #     #   ## #   # #  #    #   #       ## # # ##  ## #         #     #   ## #    ##   #    #  # #       ## #    #   ##   # #  ###    
#       #     #      # # #   # ##  #      # #   ## # ##  ###  #   ###  #      #     #    #      ###  # ##   # #        ###   #  #   #  ## ##      #        #     #  ##   ####   # #  #  # #   ##        
# ##   ## #   #    # ### #  # #   ##  #    #  ####   ## # #       #   ###  ##    #  ##   #         #                #      #       #    #   #  #   #   #     ##  #  #   #  #   ###  ###  #    ###  ##  #
   # #       ## ##         ##  # ##   # ##     #      ##   ##      ### ###      ## #    #   #   #    # # # ## #  ###  ###  #    #  #  #   # ## #      #    #  #   #    ##  #                  ##  #    #
## ##    # #          ##  # ##     # ##   #      # #   #  #  # #    ## #### ##   ###  #       #### #     ##       #    #           #     #        #  #  ##     #   #    #   #  # #   ###    #  # #    # 
   #      #    ### #     ##    #   ## ###   ##  ###     ##    #         #  ## # ## # #  # #     #  ###     ###  #    ## ###    ##  #     ## ###  ##   ###   #     #        #     #  # #     ##     # ## 
   #       ###    #  ##### #     #  ##      #      ###    #   #     #  #   ###   #  #    #   ##   #  #     ##  ##      #       #    ## # #            # ###  # #   ##   #     ##  #   ##    #         ##
    # #  #  ###  #        #  #  #       ## # #     #       # # #   ##  #  ##     #  # #   ##   #   #     #   ###   #  ## # ## #  #  # # #   # # #  #      #      # #  #  ##  #    #             # ###   
     ###     ## #    #     #  #   #        ##   # # ##   #   #   ## # #     # ## #  #     #   # #  #  ##      #     # #    ### #   ##       #        # #          ##       # # #      #        # #    # 
        # # #  #       ##   # #        #   #  ##    ###  #    ### # # #       #     #  #       # #  ##  # # #      # #  ## ##       #  #    ##    ## #  #    #   #  # ##      # ## #  #      ##     # ##
  #                 #  #            ##   #    # ##   #   # ####   #  ## ##       #   #    #   ##  ## #  #   ### ## ## ## ### # #     #    ###  # #   #     # ##  ###    #### #  #    ##  ##             
#    #   # #           #   #  #  #       #  # ##  #    #  # #  #  #  #  #    #   # ##     #         ####  # ####   ##   ### ##      ## #  #    ##   # #    # ##  #    ## ## # ##   #   #     # #    ####
 # #   #       #  ###        #  ####   #  #                 ## #   ##  # #   #      #  #     #  # #   # #  ### #      #   #    #   ## #    #    ##  ##   # # ##  #    # #   # #      #    ###      # ###
 #       #    # #       # #  ##   #   #               #### #   #  #       #         #     # ###      # # #             ### #  # ## #   ## ##             ###   # #  #   # ###    ##             ##    # 
##  # #   ##  #   ##  #   ##  #            # #  #     # # #  # ##    ##   ##     #  ## ## ##  #    #  #  #  ###  ###     #     #  ##    #  ###      # # #         #  #   #     ##     #    #            
 ## ####  #    #        ## # #     #            #  ###      ##      #   ####     # #### #   #  #      #           ## ### #  #    #        #  #  ## #    # #  #    # #         #  #   # #    #      ###  
   #   ###  ###      ###  # #   #    #  ## #  ###     #                 #       # ###  ## ###   #   #     #  # #  # #      # ##      ## #                ##        ##          ## # ## #   #  #  #   #  
  #      # ##  #    #   # ###       ##  # ## ##   # # # #      #     #  #  ##  ####      #  #   #   #   # #    #     #  #  #    #         # ###     #    #    #  ##   ###         ##        #   # ### # 
       ##    #   #     #  #  #  ##  # #  ### # ##   ###           ##   #    #   #   #       #      # ##   ##  ##    #   ##            ### #   ####  #    #               ## ## ##       #   #      #   #
 # ##  #   ## # # ## # # ###    #     #   #  #  #  #    #   #   ### #   # #             # # #   #   # #### #    ####  ##   #### ##  ##    #  #        #    ###     #     # #    ## #  ## #   #  #   #   
 #  #   # #     ##   #  #               # # ## #  #   # # #  #  ###    ##   #   ##     ##   #       #  #       #            # ##      #    #    #              #  #  # #  #    ##  #           #  #    #
#   #  #          ##      #  #        ## ##   # #               #    #    ##       #  #   #   # #   # #     #  # #       ##    #    #  #     #   ## #  # # #       #      #   #  ##  # # #   #      #   
  #   # # #    # ## #       #       #  ##     # #  #  #   # # # #         #        #   ##  # #    ##  # ####        #  # ###    ##   ####         ##     #  # ##  #      #         #  #      #  # #  ## 
#  # #   #  #    ##  #         ##  ##   ######  ##  # ##   ##       # #   #     # #  #   # ####      #  ##   ## #    #  #   #    ##  # #  # #    #   # #   ##     ##  #  # #  ##        #  #  #  #    ##
 #     ##   #  # #   #     ##   #   # #####  #   ##### # #         # #   # #  # ##       ##          #       #    #   ##   #    #   #   # #     ## ###          ##       #      ##    #         #       
#  ###      # ##         #  # #  #       #    #   #        #  #   ### #     # #      # #  #  #       # #     ## #  # #     # ##  #    # ##    # #  # #           #   # ####         #####   # # #   #   
# #         ##       #          ##   #  #  # #   # ##      # # #    ###         #    ## # ## # ###  #        ## #        #   #  # # # ## ##   #   #           ##    ## #    #   ##  #  ##      ###      
#      # #      #      #     #  #   #    #    ##   #    #    #         #    #   # #                   #        #    #    # #    ##  #  # # #  #               #    #   ###        ###  #  ###    # #  # 
  #  #  #  #      # ###   #  ##        ####  #                   ## #    ###    #     # #### ##   #    #     #      #   # ## #  #   #   # ###      # # ## #         #    # ## ##   # #        #    ###  
#   #    #    #  # #  #   #   #    ## #   ##  #    ### ##     #      ## #  ##    ##  ### ##    #     # # #       #  ## # #  # ## #    #          #      #  #  ##            #    # # # ###      #    ## 
     # # #  ## ## #       #   # # ##     #       ### #  # # ####  #  #  #  # #       ##      #  #    ## ##    #         ####   #         #          ##    #   ##     #    #     ##    #  # # #   #    ##
#     ##         #  ##          #   ## #      #  #    ## ##   #   # # ##   #     #  ## # #    #   ##             # #      #  ## # # #        # ##   #   ## ##  #  # ### ##              ## ##   #       
 ####    ### #       #    ##               # # #                  ####    #                    #  #  #         ##   #  ##        ##       #        ###       #     ###       #     #    ## #  #      ## 
 #  #   #    ##       #  # ##  #     #  #   #        #  # # #  ##   #  # #    #      #  ##  # #   # #  #       ### #           #   #     #  #     ##  #    #  #         ##     #    ###     # #     #  #
   #                  #   #     ##       #      # ## ##  ##     #     # # ##     ##  ##  ## ## ## #  #   #  #  # #   # #     ###  ##   ##     #   ##       #    #   #     #        #  #      # # # #    
# #  #  ## #  # #   ###        ###  #  #   #   #    #   #  # # #  #         ##   #    ## # ##   #   ###### #  # #    ###  ##    #   # # ##        ##  #  #             ##              #      #### #    
 ##  #  ###  #  ##  # #  #### #  # ##      # #     ###  #    ##     ##  # #  ##  #    # ##   #     # #   ##     ## ###   # # #  ##  #### #  ### #  #     ##### ##      # #  #   #   #    ##           ##
# ##  #  #   #  #  #  #  # ###  # ### ###   #  ##       #     ## #     #             ##     #      #     #  # #  #      # ## #        ##   #     #   #  # # ##    # # #  ## #   ## #  #  # #  #     ## #
      #  # # ##    #   # ## # ## # # ##   #        ##### # #  #   #        #        #   #     ## #  #    ##  ##       ## #      #  # #   ##### # #  ##  # ## #   #         ##    ## #        ### ###    
   #  # ##  #                  #    # ## # #  #   # #   # #        #   ###  ##  # #  #  #  # # ##       #   ###    ####  # #    ### #  # ##### # ###    #   #     #  #         #      # #   #   #    ## 
#  # ## ##   # #       ##  #     # ##    ##   ##                 ###  ##         #     #      ### # #   ########  #   #    #        #   #  # #      ## # #   # ##  ##   #   #   # # #   #  #        # # 
  #  # ##    ##   # #         ##            #     # ## #    #  #       ###  #  #        # #     # ##   # # #   ##      #        #  #     #     ###  #         # #  ##  #  #            # # #           #
    # #      ###  ###        ##   # ##      # #       #  ###  ##  # ###     ##   ##  #     #    #  #   ###       #     #      #      #    #      #     # #    #  # #          #    #        ##  # #     
       #              ###     ##     ##   # ##  #  #  ## #     #   #  ### ####     # #    #           ###  #  #           #  #    #  ###   # #  #   # ##              # # ##  # # #  #    ##            
   #  ##     #    #        #                ## ####     #     #       ###    ##  # # #   # #   ###     ##     #       #   #          #      # ###    #  # #  #   ## #     #  #      ##     ##           
  # # #    # #   #           #     # # ## ######      #  #        #  ##      ###  #####   ##    #  ##### #     # #     ### #   ##  #  #      ##      ##  #  # ##   ##    #       #   #  #  #  #   #   # 
##        ## #    #          #  ###  #     # # #     #  # #       #  #    # ## ##  #  #     ##      # #     ## #  ### #  #    ## # #            #   #    #    #      ##  #   #        ##    ##  # #     
#  #   ##           #  #  #### ## #### #   ##    #     #   # # # # ## #   #      #  #    #  #  # ## # ##     #  ## #  ###    #  #   # #   #     ##              #    # #  #    # ##   ###      ## # # ##
     #     ##     # #    #     ##     #   ## #      ##  # #   # #   ##   ##    # ## # # #  #      #    #   #   #   #    #      # #  #     ##  ##     ##    #         # #       #   ###  ## #     #   # #
   #             ### # # ### ###          # ###       # # # #  ##  #   # # # ##   ####         #  # #   # # # #           #####   # # # #   # #   ###           ##  ##   #      ## # ##       ##    #   
   #   # ### #        # ###       #  # #   # # ###     ###  #     # #        #   # ## #     # #     ##  ###   # ## #   #     #  #     ##  #        #### ##     #     #  # # ##  # ## #    #   #   #  #  
# ####    #  #     # # #### # #   # # ##  # #        ##  #  ##  ##    ##  #  ## ## #   #  #     ## #   ##  # #   #      ###   ##  #  #  #       #     #        #  # ##   # # ## #  # #        #  #     #
# #   ##  #           ##     ##  ##  ####          ## ##   # # #  #    #        #     ##     #   ###  #   #   ## ##  # # #  #      #   ##    #  #     ##      # #   #          #   ##           #       
     ### ## ##  # ###  #####         #    ##       #  #  # # #  ## #  #       ## # # #      #      # ##          ###  #    #   ##  #       ## #  #  ###    #  # #   #      #     # #  #     # #     # # 
   # #      #   ## ##    #     # ##         ##              #  #    ##  #      #  #  ###        #         # # # ##   #### ##   ###       #  #     ## ##           #       #   #     ##         #  #   ##
  #  ##  #  ###  ## ##        # ##   # #   # ##  #   ##      # #   #  #   ##   #  #    #    #    ##  ## ##  #####     ## #  # # # ###      #     ##      ##       # #   #  ### #  ### #   #    #   # #  
    #   ##    ##  ##     #    #  #    #  ###  # # # ##  #   ##     #       ##       #          # ###       ##  # # ##       #   ##  ## ## #   ##   ##    #  #    #  ##  ##  #   #      # ###  ## ###   #
    ##  ### #   ## ####   #     ## #  #  ##         ##   # #  #        # # #  #  #           #     #  # # #    ##    # # #             #       # #  ##         #  #   #               # #     # #       
    #       # ##       # #  #  #   ##      #    # #   #    #   # # #      ## ##        #  #            # #    #  ## #   # #       ###### #   # #     # ##  # # #   # ##  #          #        # #   ##  #
        #            ##    ##      #    ##   ## # #  #   ## #    #   #   # ##   # ## ### # ##      #    #         #   #    # # #       #      #  #        #    ##  #  #        #    #  # #   ## #   ##  
#   # #       ### #        #    ###      # ###  # ##  #     #   #    #    #  ####   #  # ### # #       ###  #   ##  #  # # #   #  # #       #  ####      # ##  #  # ## #  #   ##   ### #  ### #   # # # 
 #       #      #     ## # #### # #   # ## # #   #         # ### ###    # #  #   # #      #    # #      #  #  #          #      ##   ##      #  #    #         #  ## #  #      ##       ##     # # ##   
    # #       ##  # ## ##     ###   #     #             ##        ####     # ##      ## #   ##       # ##  ###   #  #   #    # ####  ##  ## #         ## #           # #   ######  ##    ## #  #   #    
 #  # ## #   #   # ## #   #   #   #     # # #    #     #  ##  # #   ### #    #         # ##    #    ##  ###     # # ## ##        ###                 # # # ##      # # #  #     #   #  #####  ##    ### 
#    ## # ##   # #   # # #   # #     ##   #     #        ##                 # # ## ###        # #   # # ##     #       # #  #  #             ###   ##    #   #        #  #    ##        ##### ##   # ## 
#              #  # #    ##   ##        #  ## # ##    # #     ##   # ##     ##    #      ### # #       # #   # ####   #  ##    ##    #       #        ##   ## #    #   #  # #    # #   # ### ##        #
  ###  #      #  ##  ##  #          #  ##     #               #  ##  #    ##    ###    ###  #         #    ## #     # ### # #  ###  #    #     ##                  ###   # ##       #####  # # ## # #  #
         ## #       #  # # #   #      # # # ## #   # ###      #  # ##     ##    ##     ###   ## #   #    ###   ###    ### # #### #  #   ##  #   #    #         # ####             # #  ##   #           
#      # ##     ## ###    ## ####          # # # #      ##  # #  #### #   # # ##  # # ### # # #  # ####             ##   ## ###  ##   #    #  #    #   #   ## # ##   # #  ##      # ##         ##    #  
   ##    #      #         ##  # #  #  # #       ## #   #  #      ## #     #   ##       #     #     #   #   #   ###      ### # ####  ###   ## #     # #      #### # #   #   #      #### #     #  ##    ##
#  ###         #      # # #         # ## #     #     ## #     ##  #  # ###   # ##   ####   ## ##  # # #  ##  #  ### #  #       ###        #   #  ### #      #   # #         # # #     #    ##       ## #
  ###    ## #    # ## #  ##   ## # #### #    ## #   ##  ## # #   ##     #    ###   #   ## #      #    #           ## ##     # #       #### #     ##  ## # # #          #  # #   #    ##  ##      #  #   
 #    #  ##     ##    # # #   #  #   #   #     ### #   ####  # #      ##    # # #       # #  #   #  #   #   ##       #       # ###        # #     ##   ##  #         #  #        # ####   #    # # ##   
     #      #                # #  #    #      #  ##       #    #  # #    #       ##     # # #     # #     ###   #    # ### # #  #      #        #         ##  ## #  # #  #  # # #     ##  #    ##    ## 
##       #  #         # ### #    ##    # ###        #     # ## #         #  # ##    # ### # # # #  #     #      ## ##  #      #   #   #     #### ####### # # ####      ## #  #  #  ####   # # ####  #   
 #    ## #         ##  #         # #  ##  #     # # ##       ##      #        #    #    #     #  # #        # ##      # #     #     ####      #  ###   #     #  #  ##    ##    ##      ##   ### #  #    
   #   # #      #  #  #      # ## ##  #    #       ###      # #   #  ### ## # #     ##       #    # ##                            #     ##       #   #      #  #  # # ##   #       #    # #   #   # #   
        ##         #     # #   #  #  #       ##      # #     #  # #   #   #      #     #   #   # #       #  # # #       #    # #   # #  #      # ##   ###           # ## ####  #  # ##      #   # ## #  
 #         ## #  #  ##   #        ##      ### #            #         #  #  # #   #  #   # #  #    #    #   ####       #      #   #    ##        # ##   # ###  #   #     #      #      #  #  ##      #   
       #    ##            #         #   # # # # #  # #   # #  #      ##    # # # # #   # # # #   #  #  # ####     #    #         ###  #       # # #    #  #  ###  #  # #  ## # ##  # #  #            #  
##      #### # ## ##        # #     #           ##            #  # #       #  #   # #  #   #   #        #     #  #            ###   # #    #  ##  #     #   #         #     #### #  #     #  # #    #  #
 #        ###    ##     #     ##   #         #  #  #     #   #       #          ##     #  ## #                       ##   #         #       # #                   #     ###    #           # #    #  ## 
   # #   ##   #          ###  #####      # #   ##        #     #      #  #  #  #        # #  #### #   #       ###   ##         #  #    ###  # #         #       ##  ##  #      # # #         #   ### #  
 #     #    ##   # #  ## ##                # #       #  #                #   #  # #    #  #  # ###    #     #   # # # #        # # #     #                      ##  # #  #  #  #  #       ##  #  # # #  
 # #  #  ###    ###    #  #      ##   # ### # ##           # #  #          #   #      ## ###      #   #          # ### ###  ##  #  #  ## #       #    #     ##  #  ##   ##  # # #  #           #  ##  # 
#              #   #   ##  #   # #    #       ##                ####      #    #### ## ### #   ##  #        ## #  ## ## #     ##       #  #      # #   #  #   ## #  # # #     # ###   # #  ###    ##  ##
        # #       #   # #           #     #    # # #     # ## #         #   #    #     #            #     # #     #   ##  #        #      #   #           ##       # #  #   # #  # # # ### # ##   #   ##
 #             #    ##  # # #    # # #  # #     #    # # # # ## #    # #         # # #   ##     ##    ####   #              #   ### # #  #   # ##    #         #   ##       #  # #       ##  # #        
         #      ##  #     #  ##  ## # #   #     ##     #          #   ##       ## # #   ##  # #      ##  # #    ##    # #    # #  #       ### #   #     ## #  #      #  #    #     #     ###            
      #      #    ####       #  # ##   ##  #     ## # #     #   ##     # ##   ####        # #          #        ###             #        #  #      ## #        # # # ##      #   ##       ### #       # 
         #  #       # #             #  #  ###    ## #     # #  #     # ##  ## ####    #    #   ### # #       # # #  #     #      #       #       ###  # ##           # # ##        # ###      #         
 #  #  ### ## #     #        #   # #   ##  #  #   # #        #       #    #            # #          ##  # ##  #     # # #     #     #        # #  # #  ###      # #   # # ###  ##     ## # ##        ## 
  # # # #  #  #         #     #  ###  # # #      #  #  #  #  ###    ##        # # # #  # # #      # ##    ## #              ###   # #   #   ##      # #  ##     #  #### # ##    #  #       # #          
    ### #        #  #### #   #  #     #      #    #  ##  # #     # # # #      #       # ###   ###### #  # #       # ### #  # # #   ##   #   # ##  #     #   #    # ##    #   #    # # ## # # # ##    ## 
##     #  #  #  #   #     ##   ###             ##      #   # #  # #  # #  # ###   #   # # ## #     ## # # ##      #  ###   #  # ## # ###  #  ## #  #    #   #  #   # # ## ###        # #  ## ####  # #  
   # ##      # ##    ## # #      # #    ## #  #    #  # ###   ##   #    #    ##   # ##   ##  #  #    #        ### #  ##  ##   ## #        #                       ##         #    #  # # #          # # 
 ####  #     #   #   #              # # #      ##      #   #  #   ##   ###  #      # ##      #       #  #  #  ### ###     # # #    ## #     ##    #     #   ##  #  #     #          #    # #     ## #   
##     ##            #   ## ####   ##          # #   #   #  ##        # #     ## #   #### #   # ##     #  #     # #     #      #  ##  ###     # #   ## #          #  ### #  #  #  #  #   #    #   #    #
   #  ##    #   #  # ####      #  # ##      #       #   #  ### # # # #    #  # #    ## ## # # ##    #   # # #       #  #  #  #  #      ## #   #    #   ## # # # #### # #   #  #  #  # ##           #  ##
   #  #  ## #     ###  # #                #   # ##     ###  #   ##       #            # #         ## ## ## #  #######  #   ## #  #  ## #     #      ##    ##  #    ####        ## #  #     ##   #  #  # 
        #         # ##  ##       # ###  #          # ##   #      #     ####           #     #  #  #         #   #   ###   ##                      #   ##  # ###   #  ## #         #  #   ###      ###   
     #  # #  #       #         ## #   ####                 # #  #    ## #   #    #    # # #     #      #          # # #   #                ### ##   #### #      # # ## #     #   #    ##             # #
   ##    ###   #    #    #     #     #     #### # # # # ###   #          #  # #  #         ### ##  #  # ##   ## #  # #  #  #  #    #    ##     #   # # #       #   # #  #    #   ##              # #### 
          ##  ## ##          #  #   # ##  ##      #   #   #       ##                 #   # # ## # #    #    # # ###  # #    #   ##  ###      #  ## #  #       # # #   #  # #     ####    # ## ##    #   
   #       #        ##  #   ### #  ##    #      #   #  #  #  ##       #### ##            # #          # #   ## # # #  ##            # #  ##    #  #      #  #   ###     ##         ###         ## # # ##
##     ##    #  ##       #    # # ## #              #    # #  #   # #   #  ##               ##  ##  #        #    #   #             #    #   #     ## ##   #  # # #   ####  ####      #  #     #  # # # 
    #  ## # # #   # ####  #   ##    #    ##    #           #  # #     # #   #   # ##   #      #     #  #   #   #    ##     ##       #   ##   #   #   #####  # ##   #       # ##        ## ##      # #  #
  #       #  ##          #   #     ##    #  #        #         # # #  #  ### # # ## # ###       ##  #    ## # ##           # ## # ##      #    ##   # # #  #     #     ##   ##  # #        #    ##  # # 
#### #     #    #  ##     #   ##   # #  #  #    ###   ###  #  # ##      ##  ## #  # #     # # ## #        #       # # #    ##    # # # # #   #  ####### #  #  #  #  #   ##    ###  #   #    ##    ##  # 
###       ##      #   # #    #   # # ## #   ###     # ## #        #   #  # ### #     ##  #    #   #     #      ####  #  ##    #       #     ##   #        #         #        # # #      ### #    #   #  
   # #     #    ## #  #  # ###   #   #  #  ## ## #  # #   #        #     #    ##    #  #   ##     #  ## #        ## #  ###        #   #   # #    # ##       #   ###    #   ##     ### #       #      #  
     #    ##         ###           #  #   ###  # #    # #   ##          ### #  #        #     ###     # #  ##       # #           #        #  #       #   # ### ## ###   #   #     #  #   #   #    #  # 
 ######  ##       #  ######  ##          # ####    # # ##  #  # ####    ###      # ##   #        #   ###         #    ###    # #     ##    #  # #       ##   ### #     ##   ##     # #  #       # ###   
          ##  #  ###  #  #     #   ## #    #        ###     #       #     # ##   # #  ##   ##  #   #       # ## #  ##             ##   #   # #     #      ###  ## #    ## ### #   #      #  #           
 #  # # # # # ##  #    #        # ## # ##       # #         #       # ##   # #    ##     # #  #      #      #  #   #  ##   # #   #    #    #        #        # #  ## #    ### ## ### #  #    ## # ## ## 
 #          #      # #    #        # ## #   ## #  #                  #     #    #  #        ##   #       ###  # #    #     ##   #      #  #   #  ##    ##      ##    #####   #   #              ## #    
   # #     #  #   # ####  ##  # #  # #  #   #  ##  #####   # #   #### #      ##   #       #            # #   #   # #  ###  ##   # ##      #    #    #  # #  #       #  #  #    #  ##    #    #   #     #
   # #     # #  #    # # #                  #       ## #  #  ##  ##  ####     #  # #         #               #### #  #     #     ###  ## #  #    ##    # #     #    # ##   ##    #  ## # # # ## #  # ## 
 ##   #  ##             # # ##     #   # #      ###  #   # # #  ## #     # ### # ###         #           # #    #         ##      ##    #   # #       #     #   # ###   #   #        ##     # # ## #    
##          #    #     # ##     ##       #        #  #####      #    #        # #            #     #    #        # #   ##    #      #             ## # #  #    ###    #  #  #   #       # #    ##  #    
#      #     # #  ### ##    #  ## #  #    ##      ##   # # #  #    # #    #  # ##### # #    #####     #####  #  #  #      ###  # ###    #    #  #   # #    #     #        ####      ##       ###   ###  
 #  #  #   ##  #      # # #         #      #    ##      #    #    #         ##      #   ####      #   ##                    ###   #  #      ##  #   # ##   # # # ## # #   #             ### ## #       #
#   ##     #     #     #  #  # # #  # #  #  #  #  # #      #     #            #   #  ##    ##  # #   #   #  #   ####   #  ##  # ##  ### #        ## #   ##  # ###   #       #  # #               #    ##
# ##   #   ##  #   #      # #  #   #  #                    #  #  #    #   # ###    ####   #                 ## #  # #         #  #  #      # # ##      # #   #        ## #  # ##    #  #  #      #      
      #      ##  #  ######          #      # #    #  #  # #            ### #    #    ##   ##   #   # ### ###  #  # ##  #                ##  # #    ####    #    # ##### #     ##  ## #       ##         
      #  #       #  ### #  #     #             ##     #  #    ###      #  # ##               # # #   #   #  #        #    # #  ##      ##   ##   #             ## #    #  ##   #   #     #   # #    ##  
       # ###          #  #    ####    ### ## # # ####   #  #   ##  #  #  ##   ##  #    # #   ###  ##    # ##         #  # #  # #  #  #####     #      #  ##      ## # #  ##      #  ## #     #          
  ## #    ## ## #     #  ### #        # ##    #  #      # ##   # # #   # #   ##    #   #  #     #  #   #   #   #      # # # #  #      #### #     #   #    #          #####                     ## #   # 
## ### #       #        #   # #           # # ##  #         #    ## # ##  ## #  #  #  # ###       #    #       # #           ### ##      # #  #  ## #  # # #      #    #  ##  #  # # #    ### #  #   ## 
# #   #     ## ##  # #    # #  #                         #                #      #  #           #    #      #   #  #     #      ## #  # ##  #          # # #  #     ##     # ##   ##   #     #  #   ##  
  #  # #    #    ## # # ###    #      #    # #       ## #  # #            #   #      ## #   #    ###  #        # #  ###       #   ##          #          ####  #    #   #   #     # ##      ###    # #  
 # ## #     #   #  #      #    #         ##    # #        # ##  # #  #     #     #    #         # # ### ##  ##      # ##      #     # #    #    #   #   # #          ## #  ##  ####   #       ##    ## #
 #   ## #     #    # #  # ## ##   E ## # # # #     ##     #  #    #  # # #      #   # ##           # # # #   # #  #   #     #   ##      # #   # #     # ##   # # #  # # ##  ##    #     #        #      
# # #       #### #       #   # #     #  ##    ##        # #     #   #    #      # #  #   # ## #       #  #  ##   #   #  ## ###       # #       ##  ###  #         #        #  #    #     # # #   #   # #
 # #   # # #### #    ##    #      # # #  #  # #    ##   #    # #  ###   # #  # #   # #  #  #      ##     #   #  ### #      #   ##     #  # # # #   #     # #  ##   # ##   #   #  ##   # #              #
