#        #
 S##     #
   #  #   
  #  ##  #
#  #  #  #
   #E E # 
    #     
 ##       
 #       #
