      #   
 S ##     
       #  
# #   #  #
   #      
# #  # #  
 #  #     
     #   #
##     #  
  #    # #
      # ##
   #     #
# ##  ### 
     #    
####### # 
   #      
     ## # 
#       ##
#   #     
  #  ## ##
      #   
      #   
## #  ##  
 # # # #  
       # #
   #    # 
#      #  
         #
 ### ##  #
##      # 
     # ## 
#    #    
##      # 
  #       
#  # #    
 #        
    # ##  
  # #   # 
  ##  #   
   #      
## #    # 
# #      #
##        
  # ###   
          
 ###  #  #
  # ###   
   ## ##  
 # # #   #
#         
 #   #  # 
  #  # #  
  ##   ###
#         
##  #     
    #     
# ## # #  
       # #
#         
#    ##  #
   # #  
    # ### 
    #  ## 
 # #      
 ##     # 
          
#     # # 
   #      
     #  # 
   # #  # 
  #    #
  #  #   #
 #        
   # # #  
## #  #   p
 #      # 
    #     
   #   # #
##  #    #
 #  ### ##
   ###    
 ##      #
 #     #  
  ##     #
#  #   #  
     #    
    ##  ##
      #  #
 ###   #  
   #     #
##       #
   #  # # 
 #     # #
   #   #  
# #      #
   #   #  
##     ## 
 #     #  
#   # # # 
  #  #    
  ## #    
   ##    #
 #   #    
 #  ## ## 
# ##    # 
  ##      
 #    # # 
##      # 
    #  #  
    # #   
  #  ##  #
 # # ## # 
 #   # #  
  ##  #   
  #       
#    #    
#       # 
  # ##  # 
### # #  #
  #     # 
   ##  #  
    #  E  
#  #      
 #   #  # 
### ##   #
   # #    
        # 
###       
   # #    
 ### #    
#  #  #   
 #### #   
   #     #
#    # # #
  ##  ##  
   #  # ##
 #    #   
#  ## ## #
 # ##    #
#     ##  
#     #   
  #   # # 
     #    
  #  #  ##
    #   # 
   # # #  
 ##       
 #    ## #
#       # 
    ##    
   #   ###
 #   #  ##
         #
     #  ##
   #     #
     ###  
  #  #    
## #   #  
#     ##  
 ###     #
#     ##  
          
   ##    #
          
  ###    #
#      #  
          
#       # 
  #  #    
 #  #    #
###     ##
  #     ##
#        #
#      #  
    ####  
#     #  #
 ##  #  # 
 #     ###
#   #     
 #### ##  
  #   #  #
 #  #     
####     #
  ##      
  ###   # 
##  # # # 
  #   # # 
     # ## 
       # #
 #  ##  ##
     ##  #
     ## ##
# #     # 
  ##   ###
         #
   #      
 ##  # ## 
 #    #   
 ### #    
      ##  
