  #   #  # # ## ##  #     #
                   ## #   #
   #      ## #  #      ### 
 ## #     ###    ##     #  
#  ### #   # ###  # # ###  
   #   #  #  # #  #     ###
 ###      #     #   #   ## 
## # #           # # # ## #
     ##  #### ### # ##     
 ###   # #   # ##   #  # # 
   #        # #         # #
         #       #   ## #  
      ##       #  ##  #  # 
##   #  # #   # ###      # 
##   #   #   ##       #  # 
   #   ###  #     #  ###   
# # #      # p   # ###   ## 
 ##   #      #    # #  #   
  #        #  #   # ##     
#        #    #  ##        
    ##   #  ##     #  #    
  # #   #     # # #  ## #  
 ##          #    #   # #  
       # ###   ##  ######  
  ##      ###  ##### #    #
###      ##  #    ##    #  
 #  # # #    #    ###   # #
 ## ##       #    # #    # 
#  #          #         #  
# #  # # ###    #  #  #    
    # # ##  #  ## #   #    
#      ##  #       # #    #
 # #  # #           ###    
  #    ## ##   #        #  
 ##  #   ##      # ## #   #
      #   #      # ##   #  
  # ## ##  ##          ##  
  #         #  #        E #
# #   ## #### # #     # #  
  # #     #  #  #    # #  #
     #   ##  ##  # # #  ## 
######      ##   ### #   # 
#      #  #   # # ###   #  
 # ##  #   #   #       #   
  #    #   #       # ##   #
#  #        ##  #  # #  # #
    #  #  #        #      #
###        # # ## #  #     
   ##              # ##    
 ##   # ##   #    #   #    
 #      #             #    
       #  ##         #   # 
##     #    ##  #        # 
  ##    #     #         #  
# ##    # # #   ###    ##  
         #          ###    
#  ## #  #    #      # # ##
# #      ##### #  #   ##   
# #   #        #   ##   #  
   #  ##     # #     #   ##
     ##  # #   ##      #   
  ## #         #    #      
 # # #         #  ##      #
 ## ### #     #  ##     ## 
