###  #  # #  ##
 S #   ###   # 
    #  #    # #
  # #      # ##
#  #  #  # # # 
#             #
 #   #    # #  o
##           # 
      #        
# ##  #  #     
  # #    #     
          ###  
## ###  #   #  
 ##   #  # ##  
       #     # 
##  # # #  #   
      # #   ## 
#   ## ### #   o
#      ###  # #
 # # # #    ## 
      #    # # p
   #   ###    #
 #  #     # ## 
      #   # #  o
               
#   #     #    
  #     # #  # 
     ##     #  
        #      
    #   ####  #
     #   # # ##
 ##     ## #   
  #  ###  #### 
 #    ##       
 ##    ##  #   
## ##   #  ##  
     #      # #
         #     
    #         #
#     #  #    #
    #       ## 
    #       ###
      #  # #  #
#   #          
  ##      ###  
## # #     ####
#  #     #   # 
   #     ### E#
 #   #       ##
#  #    #     #
  #      ##    
 #  ##  ##  # #
 ##    #  #    
 #    ##       
     #      # #
##  # #     #  
    ##      # #
      ##   ##  
###  #  #     #
 # # #   # # ##
#   ## #     # 
  #  # #  ##   
 #### #   #    
 ##      # #  #
   #     # #   
 ##          # 
 ##       #   #
#            # 
####  #  # #  #
 ##  #   #   # 
  #       ## ##
 ######   #    
   # #        #
## # ##      # 
##   #        #
        # #    
## #  #   # #  
 ##       # ## 
### ##   ##    
#      # #  ## 
 #    #   #  ##
   #      # # #
#  #   # #    #
## #       # # 
      ## # # ##
 ##  ##    #  #
  #    ####  # 
   #  #   #  # 
###         # #
     #### ##   
    ## # #  #  
##    #   # #  
  ####  #   #  
##    ##  #    
 #   ##   ##   
 ##   ##    # #
#  ##     ##   
###    #  ##  #
     #    #    
      #        
     #  #  #  #
  ####     #   
  # #   ##     
     # #    # #
 ###    #     #
       #      #
    #  # #  ###
  ###  #    # #
 # ## #  ## #  
       #    ## 
    #  # # # # 
   # #      # #
#   #    ##  ##
 ## ##   #  ## 
#  #       ### 
  #            
#  # #   #    #
  # #      #  #
   # ## #   #  
#     ###  ##  
        # #    
# #    #   # # 
#     ##       
     #  ###  ##
# #  # #  #####
#    # #    #  
         #     
  # #  ####    
####      #    
    ###   #    
 #   # ### # # 
     ##  #     
 ###  ##       
    ##  ###   #
        # #   #
###      ###   
   # #   #   # 
   #      ###  
#             #
  # #    #     
   # ###       
     #     ## #
   #  ##  #  # 
   #  #   #  # 
 ##     #   # #
        #     #
#   # #   ##   
