  #    # #       # #    #   #         
 S     #  #   #    # #  #     # ###  #
     ##  #  #### ## #  ##  #   ###  # 
           #  ##     #     #       #  
 # #   #            # #  #   # ## #   
 #   #    # ###        #      # ##    
  #       ##     ### # #     #  ##    
 ## ##       #  # # ##   #    ## #   #
      #     # # # ###   #    ## ##    
# #        #    ##     #   #         #
#    # #   #  #    #   # #    #   ##  
 #  #      #  #  ##      ##      #  ##
         #       d      ##  #    # ###
## # # # ####    #  #  #        ##   #
  #  # #       ### ##### # ##  # #    
 ##  ## #    # ##   # ##   # ##  # ## 
  #    #   # # ##       #  ###    ### 
      ###             ## ## # #  ##   
#           # # #  ##         #     # 
   # ## #   #      #  #  ###     # ## 
   #     #          #   # #  # # #    
   #   #   d   ##        #  # #   #  #
 #    ##   #  ###  #    #  ##   # ##  
    ##  #  # #         ###  ##  ##  # 
 ##       ##           #  ###   # ##  
##               #  ##### # # ##  #   
 #    #   # #    # #   ###  #    #  ##
   #         #     ##     ## #        
                 #  #### #  #  #   # #
  ##   ##        ### ##   #  #    # # 
## # #  ##      #  #     #         #  
 #  #    #         #    ##          # 
##   ###               #  #  # ##  ## 
 # #  #  ####  ## #  #    ##   #   # #
     # #  ##   # #    #      ## # #   
 #    ###   # # ##  ##   ##  #        
# # ##  #      #  #  # ## #    ##     
       # # # #            #   ### ## #
##    # #        #  ###           #   
    #      ##       ## ##       # # # 
   ##     #         ##      # ###  # #
  # # #            ###        ##      
  #    #  ##  # ###     # #     # #   
   ##       ##        #  ##  # #   # #
 # ##   #  #          #    #     ##   
#      #  #  #   ##  #    #  #   ##   
              # ##  # #      #    ##  
   # #   # #     #          ###    # #
      # #  #       #   #  #      #   #
      # ##  ##   #       #   #     ## 
#  ##  #        #   # #      ####  #  
      # #  ##  #      ##     ##     E#
 ##              #  #  #  # # #    # #
   #         # ##  #  #              #
 #     #   #   # #          #  ##   # 
  # #### #          #         ## #   #
   #  #  # #    # # #          #     #
