#     # # #     #    #  ########    # ###    #  ##  #  #         # #      ##   ##     #  #  ##     #   # #  #      #   #  #    #
 S # # ## #   #  ## #       ####    #   #          ##          ##      #  ## ##   ##  #     # #    ###        ###    ##         
       ## #   #   #   ###   #   # ##   #  #        ###   #      #  ## # # #      #    #  # ##       # ##     ###                
  ##   #  # # # ##                #  #   # #   #  #      #       #  # # #        #    ##  ##     ###   #   # ###  #      #      
  #  #  #     #        ##      #  #   #    # #      #  #           #    #     ## ###   ## #   #  #   # #   ## # #       # # #  #
  #  #    #       #     # #          ## # #  # #    # # ###    ### # # #    # ##  #       #    ## # ##    # # # #   #  # # ## # 
      # #      ##   #### ##   ##       #     #     # # #   #  ##  #       #     #    #  # #  #       ###    #  ## ##       ##   
     ##   ##### #    #####   ##    ## ##  # ####    #    ###         #   # #    ##   #     # ###         #   #    #  #      ##  
 #  ## #     #       #     # ###  ###  ##  #    # #     #      #   #  #  #    #  ##  #   #  # # ## #  #     #              #   #
## #  #    #   ##  # #         #        ## #      #       ##  #     #  ####   ##     # # #     ##    ## #    ##       ##  #  ## 
   ##      #     #   ##  #   ## ##        #   #  ## # #  ##      ## # #         #     #  #     #     #      ####  # #######  #  
 #  #   #  #    #      #  #  #   # #    ##  ##    #  ##     #####  ##         #  ## # #    #   ##  #   #      #  #   #       #  
 # # # #  ##  ##  ## #   #     #  ##     #      # # #  #  # #       #   ## ##    ##   ### #  ## # ##      ##   #   #    # ##    
     #  ## #      #  ##               # ## #  #   ### ####  #  ## #  #  ##     #    #         #    #    #                       
# #    ##   ##     #     #            # # #        # # # #    #       #    #        ##  ##   # ###  #  #    ##       # ##  ##   
   #   # #     # #   # #  ##  #  ##   #  #  #  ## # #    # ## #    #   ##     # #       #   # ##        ###       # #  #    ##  
 #   # #  ## #  ##      #  #####  #        #  # #         ##     #  ##                 ## ##     #    # ####   ### #       #    
 #         # # #   ##   #      ##    # #   #  #  #  ## #   #  ##  #      #  #  #   # #    #### # #  #              #      # ## #
 #   #    #   #   ###  #   # #   ###  # #  #  #       # ###     #  ####     #       #       #####  #  # #    ##  #  #    # #    
 #  #      ##  # #  #### #  #           # #  # #   #  # ###   #    # #          ###       #     #        #     # # #    ##  #  #
    ## ### # #     #  #    #  ####  # #        ###   # # ###   #    ###            #      #        ##  # ##   ##  #    ##       
# # ##  ### # #   #  #  #   ## #   ## #       #   #     #   #            #    #  ## ##            #     #     #    ### # ## ### 
   ## #  # ###   ##         # ##    # #  #  #      #           #   ## #   # ##  #      # # #    # #    #   #          # #### ## 
# # # #  #      #  #         ##  #    #   #   #   #   #  #  #   ##     # ##         #   # #  #       #   ## ##         #   #  ##p
       # # ## #   #      #     ## #    #  #              #  #  ##  # # ##   #     ## #    #     #  #### ## #            ##   #  
  #    #   #     ## ## #   #            #    ####  #  #     #   # # #    # # ##  #  #         # #  #   ##  #   #       ###  #   
 # ####   #    ##   #  ##    # # # #  ## #   ###   ## # # #      #  #  ##    #     # ## #     #                #    # # # # ##  
   # ##  ##  #  #   #   #  #      ##   #   #    #  # # # #       # ### #  #   #    #  ## #   #      # # ##       #  # #   ##  ##
  # #  #  #   #                     #  #  #    ###          #    ## # #    #    # #   # # # ##  ##    # #   #          #    #   
#                #  ##    ##   #        ##   ##     ###    # # #  #  ##      ##  ##    # #   # # #     #### #     ##           #
# #  # #       # #  #       #   ## # # # ### # ##  #  ##     #   ## #    # #  #           # #        #  ##    # #        ##   # 
 # # #   # ##   #           ##   # ##   ##   # ###                     ### #  #    #  # # #    #      #        #             ## 
    # # # #              #  #    # #        #      # # ##  #  #      #      #    ###      # #    ##  #      # #  #  # #####  # #
 ##     ##  # ##  ##  ## # #    #  # ##  #  ##  # #  ###     ##  # #    ## # ##              # #     ##    # #         #  #   ##
    #   ####          # ### #  ##  # ##  #    #       # ###  ##   ## ##              #  #     ##   #       # #   #     # #    # 
                  #  ##  #       ###      ##  #     # ##      ##  #     #   ## #  #  #  #            #  ##  ## ##     #    # #  
 ## #    #   #   ##    #     # #      #  # #     ##     #      #       ##  #         ##     #   #    ##   # # ##  # #  #  ##    
  # #    #    #  ##      ### #  #  #     #     # #       # #      #E # #        ## # ##    ##  #    # #   # #       #   #      #
 #      #     ##    # ###   #      #      # ####  ## # #  ## ##     ##  ##    #     #   # # # #    #      ##   #    #  #     #  
 #    #     #  # #  #  #       #     # #      ###   # # # #  # # ### #  # #      #         #  ##   # #  #      #   #  # #    #  
 #       #### # # #       ##  #    ##  ###   ##     #    ##     #  #     #  #   #   #  #  #  #  #     ##   ## #    # # #     ## 
 #  #  #  ##  ###            #   ###      ##      ##  #  ##   # ###    #  u#  #  ##   ###     ###  ##### ##    ##  ### #  #    # 
  #  #   #   #  #     ####    ##   ##       # #                 #     #     # #   #               # ###     ##   #   #  #       
#          # #    #   #### ### #  ##  ###         #      ### # #  #   # #    #   #     # ####      #  #    ###  ##   ##   #  #  
 # #   ##   ##   # #     ###        #  # ## #      # ##      #   #  #    ## #  #     #   # ###  ## # #    # ##    #   #  #      
   # ###  ##    ##  # #      #  # #   #  ## #   # #    # # #   # #      #      #  #     # #        #  #  # # # ##      ## #   # 
### #  ##  #   #  # ##  #  #      #       #  #  #   ## # ##  ###  #   ##               #    # #     #  ## #    #   #    # ##   #
#  #   ##        ## #  #  ##  #    #   # #  #  #             #####  # #  #    # #  #         # ##   #     # #### ## #  # ##    #
 #      #   #        ###  #         #    #  ###    ### ##      #  # #    ##    ## #  #    ###     #  #  ##     #       ##    #  
 #      #   ### ##     ## #    ### #  #  #  ##   ##          #   #      #   ##  #   #     #             #    #     #    ##### ##
#   # #  #      #    #   # # # #  ##   # ###      ### #  # ## # # # # # ##  # #  ## #    ##   # #   #     ### #  #   #      #   
  ##    # # # #  ### ##      ##   #  #    #      # #   ####   # # #       #  # ##     ###    #   #        #  # #  ####  #   #   
  # #  #    # # ###   # #  ###### #   #  ### #             #  ##    #  #        # #  #    ##    #   #   ## #  ##   #  ##    #   
## ###   # #         #    #   #  #  #  #   # #  #        #  ## ##    # # ##    #    ##  #    #  ## #   #  #  #   #      # #  ###
 # # ##   ## #  # ## #  #   ## #        # #  ##  #       #           #  #### # # #     #    # # #    #  # #       ### #  #   ###
###   # #  #  # #     # #    #    # ###   #     #  ##  #      ##  #    ## #   #           #    # #     #### #   #  #      #     
         #    # # #  #     #    #     #       #    ##  # ## # #  # #    ##            #    #  ##                ## ## ##  # #  
     # # #   # ## #  ## # #     #    ##    # #        #   #  #   #      # # ##  #  #   ## # ###   #   #       ## #              
     # # ###   # ### ##    #       # ##  ##            # # #   # #   #   #   #   #  #   ### ###           #     ###  # #    # ##
     # #    #  #  #    #  ##   # #  ##       # # ### ## #      ###            #  # # #        ## # ##    #  # ##  # ####    #  #
 ##    #  ##      # # # #  #    #   # ##      ##               #####   #              #  # #  #  ## #   #   ##  #         # ####
##  #  #   #  ###   #            # #   # #   ##    #  #   #  #   #  #   #       ### ####  #  #  #  ## ##           #  #    #### 
       #     #     ##              #     ##  # ## ##### #  ##     #   #       #####  ## #     # ##   ##  ##  # # #   # # #  #   
      #   # ##      #  # ##   #   # # # # ##    #  ###  #      #    # #   #        ##    # #  #  #  # ###      #    ##        # 
##       ##  #                # ####   #   #       #     #   #     # ##   ###       # ## ####  #  ##  # # #        #  #         
#  ##   #       # #  #     #  #  # #         ##  ###  #  #            #               #        #   ## #         #   #     #    
     #    #     # #  p###  # #      # # #   #    #         #   #  #    #  #### #           ###  ### #  # #    # #   ##   #  #    
