   #### #    #   #         
#S ## #    # #  #  #     # 
  ## #### #   # #  #   # # 
 #    ##            ##  # #
 #   #            #   ### #
     ##   # ##          #  
#      ##  #     #     #   
  ###   ## #  # # ##    #  
##      ######     #  ##  #
  #   #  #  # #       ##   
###   ### #   #  # # #     
 #     ### # #  ##  #  # ##
  #   ## #  ### ## #  #    
  ###  #         ## # ## # 
        #  #   #     #   # 
 # #        #   ###   # 
  # # ##   #  #  #  # #    
  ##                   #   
     #       # ###    # #  
 # # #               # #   
 #     #     #  #   #  ## #
# ###    #           #   #
 ##       # #     # # ##   
 #  #     # #  # #    #    
#  #  ## #   #     #  # ###
 #####  #   #  # #      ## 
 ###    # #    ##  # #     
 ##  # #      #  #  ### ###
 #    #     # ### #   # ## 
  ##    #      #   # #   ##
  # #       ##  ##  #      
      #    # ##  #  #      
 #      #     #p## #  #   # 
  #           # # # #      
         ## #     # E  # ##
  # ##  #   #  #     # # # 
##  # ## #   ##   #  ###   
 ## #        #  # ## #  #  
#               #          
## # # #              ## ##
  #  #         ##  #       
###   ##        ### # #    
  ##  # #  # # ## # # ## # 
    ###   #  #  # # #      
    #  # # #  ## #    # # #
##  #     # #      #    #  
    #  # ##       #   ##   
  #    #   #     ###      #
  ##     #     #  # #####  
  ## ##  #   # ##  ##   ## 
# #  ## #   ###         #  
#    ## #   #   #      #   
        ### #   #  #  # #  
  ##   #    # # ###   #####
####       #    # # #      
      #  #       #     ### 
  ####    # #  #       ### 
  #   #       # #          
  #    ####  #     ####  ##
         ##    ##  ##     #
   ## #  ###    #  ##    ##
      ##       #  #      # 
###  # ##    ##         #  
#  ##     #       #      # 
  ##   #     ###   ## #  # 
## # ## # ##  #      #    #
##  ###    # # ## ####### #
 # #    #  ##   ## ##   ## 
 #  ##  ##     #   ##   ###
 #   ###  # #   # ## #  #  
 ##      ##      #  # #    
#   # #  #                #
#   #       ##  #    ###   
 #      # ##   #     ##   #
 #   # ##   ##    #  ##    
   ## #     ## ## #  #### #
     # #     # #    #    ##
     #  ##   #     ##  # # 
  #  #    #          #     
# ## #   #    ## ##  #   # 
# ##      #         # # #  
#    # #  #   ## # # # ## #
   # ##                    
 #    ##     # #     ###  #
##        #  ## ##  # ### #
 ##          # #### #      
    ###        #      # #  
     #      #   #      # ##
          ##         #     
 #        ##  #  ###    ## 
  # ##     #   #      # #  
  ##    ###    #  # ##     
###  #   ##    ###    ##   
#   #    ##  #   #  #    # 
  #        #  # #  #     # 
  ## #  #    ##### ##      
    ##  ####  #          # 
## # ##     ## #  #   ##  #
# #  #           #         
##   #  #     #    #       
             ##  #    ## ##
 ##   ######  #   #      # 
  ##     ## #     #     ## 
     ##  ##  #     ###  ## 
# # #      ## ##   ##      
          # # ## #   # #  #
  ## #   ###   #  #        
  # # ## # #   #     ##    
#  #    #  #    # ## # #   
 # #    #  ##         #  ##
## # #           #  # #   #
  ##    # #  #        ##   
#  # # # ###     ## #  ##  
  ## # #       #  # #      
 ##  # #    #      #   # # 
#    # ## #   # #   #     #
  #     ##  #       # #    
# # # ##  #   ####   #   # 
## # # #       # #       # 
 # # #  # ##  #    # #   ##
   #  ## #  # ####    # #  
       ##  #    # #  #  # #
  #     #  # ##   # ##  ## 
       #    #      #   # ##
  #   #   #   #     #    # 
#      # #           #     
# #                   #  ##
 ### ## ##   ### #    #    
 ## #   #     #   # #      
#  #  #           #       #
 #   ###   ##  # # # ##    
        # ###  # # # #     
#     ##  # #  # #     #   
   #        #   # #####   #
##    #    ### # #  #  #   
 #            #   #  #  ## 
       #    #    ##   ## # 
     #       # ###        #
 # #   ## #     #      #   
  ##   ####    ##     #    
   ##  ### #   #      #    
#    #            #  # #   
  #       ####  #    # ##  
#     # #     # ##  #    # 
###        #    ##  #  ## #
         #  #     #    # ##
     ##   #   #      #  # #
         #  #  ###   #  # #
   ## # ## ####  ##        
  #       #     #   #   #  
#  #   #  # # #      #   # 
#     ##      #     ##     
          # #       ## ##  
#  #  ##    # # ##    # #  
    ## # ##        ##     #
 # #  ## #   ####   #####  
# #  #  # ##  ###     # ## 
#  # #  #        #  #     #
#           #      ###   ##
         #   #  # ### ## # 
   # #     # # ##    #    #
    ##   #      #   ##     
         # # # ### #  ##  #
 #  # #      #  #     ##   
   #  # # #               #
        # ##   #    ##   ##
           #  ##     ##    
  ####  #   #  #     ### # 
##      #    # #  ###      
#       ## #    #  #  #    
 #        # # #   #  ## #  
 #      # #      #      #  
   ## #    ##    #         
      ## #      ## #  #    
 ###  ## # # # #         ##
#  ##     #   #  #  #      
###  # #        #  ##   #  
  ####    #  #####    ##   
    # #  ## ##   ##  ##   #
 #   #  #  # ## #       #  
