      #             #    #    #   ## #   ####  #      #   ###     #        #      #    ##  #        # # 
 S   #   ### # ##  ##  #  ##       ##   #   #   # # # ##  # #               #      #   # # #       ##   
   # #  #      ###      #   ###   #  ##  #  ##         ## #    #  #  # ## #      ##  #           #   ## 
##        #    ##  #      # #    #  ##   #  #     ## # #  #   ### # ##   ###  #  #          #     #    #
    # # ####   #   #    # #    ###       #   # ### #   ##             #  # #        #  #               #
   #    #  # #   #    # #   ##  #           #  # ## #                ### #   #      #     #    ##       
    #        #         #   # ## #  ##      # # # #  #  ##        # #   ## ## ###  # ## #           #   #
   #  #  ##  ## #    #        ## ###    ##  #                    #       ####  #  # #   ##   #    ##    
 ##         ##        #  # ##               ##  # #     ##   #     #    #   ##     #    #     ##    ##  
    #     ##  # # ##  #    #     #      #       ##    #      #              #  #     ## #    # ##   ##  
# # #    # # # #    #  #  # ### # ####    # #   # #        #      #      # #  # ###   #  # # ### #  #   
 # # #          #                   # # # #  #       ##  #     #    #  # ### # ##  #    #     #       # 
    ##  #  ## #   # #  #   # #     #  #  ##       # # #     ##  #  # #      #      ##  # #   #  #      #
##  ### #  #    #  #     ##      # ##    #  #  # # # #  ##             # #  ###     ###    # ###  ####  
# #       ##   #         #  #    #   # #   #      #      ## ### #          #       #      #   #   ##    
  ##  ## #       #    #  ##      #       ##            #   # #     ##  #   ## #  ###  # #     ## # ## # 
#               ##          #  # #  # #     # ##  E   #   #  ##  #   ## # ## # #     ##     ##       ## 
 ##      #    #  #    #   ##    ##       ##  #     #    #  ##   #    #  ##   #  #   #   #   ### ## # #  
#    # #       #####     #  #     # # #  #  #    # ###   ##      #  ## #  ##    # #      ## ####    # ##
#  # #   ##    #        #   # ####       #   ##       ###      # #    #       ###  ###     ## #  #   ## 
     ###     ##      #     ##  ## #  #   # ##   ####      #       #        # #  # #         # ##   ###  
 #  ### # #    #        #      ##  #      ##### # # ###   #          ###   #    ###   ###        #####  
 #    #    # #    #       ## ## #      ##  #  # ##   #   #           ####     # # # #  #  #     #      #
     ##       # ##  #           ## ##          #             ##   #   # ##    ##  # #   ## #  #   #   # 
    #     ##   #       #       #  ##       # #         ## #  #       ##   ###  ##  # #  #     #     ##  
   #   ## ### #  #  #  #    # #  # #    ##   ##  ##  #  ### #  #     #     ##      ###     # #    #  #  
#  # #   #    #  ##   # #    #     # #     #       ##    #   #       #    #   ##       #    # #      #  
### ### ## #   #####             ##    #  # ## # # # #     #       #    # #     #     #        #      ##
   #      # #  #     #    #        ##   #  #        ## # #   ## #     # ##        #   #  ##  #     #### 
# #  #   ### #   #      #  ## ##   ###  ###  # #   ##  #  #      ###   #  # # #   #### #  #      ##  ## 
# ####      # #   #  ### # ##    # # # #  ##   # #        #        #    # ## # #  #  #   #   ##      #  
   #  #              #  #    #  ##     ## # # # ##  #### # #   ## #    #         #      # ##  #       # 
 #  #  #  #   ## # #    ## #    ###   ##   #         # # #    # #  # #            ###   #  #   # #   #  
##   #     #     # ##  ##     ##    ## # #  #    # ###  # #     ## #   #      #       #  ##  ###        
     #  #    #   #  # #   #    # ##       # ####         #  #        #      #     #  #  #### # #   #    
 #  #    #      #### #         ### #  #      #       #  # ##  ###   ###  #  #     #  #     ###     #  # 
#  #   #   #  #        #  ###    #           #    # #      #          # ###        #### ##    #  #  ### 
          # #    ### ###   ##     #  # ##   # #   #  ## # #   # # # #  #   # ##       ## ##    ## ###   
   # ### #    ###       # # #  #  # ### # #     #   # #   #  #      #####    ###    # ##   #       # #  
 #   ### #  # # #  # ##  # ##       #    #       # #     # #       #   # #    #   #   #    # #  ## ### #
       #   # #  #         #   ###    #### #    #   #    # #   #            # ##      # ##  ### #  ###   
 #    #     ###   ## #   # #  #   ##          #     # #  ## # ##     #     #  #  #  #  ##   #  #  #  #  
   ## ## # #  #   #    ##  #  ##   ## #    #     #       #  #   #       #       #     #   #     # # # ##
   #   ##### #     # #  ## #      # ##   ##    # #  #   #  #        #   ###    #####     ## #   #    ## 
          #  #  #   #       ### ##       # # #     # # ##    #    #  ##  #   # #   # #  #   #          #
 #  ###  # #   #     #      #         # ## #    #  ###         # ####  # #       ##   # #    #    #     
#    # # # #     ##   #    # ##        #        # ## # ##   #   ## ##  #  #  #     #      ##  #         
    ##  #          ##    # #           #  #    #           # #  # ##   #  #   #  #  ####        # #  ###
 ##    #   #     #     ##      #         # # # #     #   # #  #     ####    # #### #  ##    #  ## # ### 
  #   #     ##   #      #    #     #    # # #        ##    #    # # ##      #### #     #  #       #### #
   ####    #   # ##      #  #   #   # #   #   # #   #        ####      #     ##      #    # # #   # ## #
       ##   # #    #  #   # #    #    ##     #  ##  ## ###  #       #   ##      ###     #        ##   # 
    # # # #  #    #   #   ## # # #  # ## #   # # # #           #     #  #       ##    ###       #   ## #
 #   # #     ##   # #  #               #  #       #  # #   ### #  #      # #   ####   #   #       ## #  
 # ## # #   ## #       ##  #          #   # # ##  # # ##    # #      # ##     # #      #    #  # ### ## 
 #### # ##    ##  ###  # #  #    ##     ####     #  #        ###     #   # ##     #       #    #   #   #
#    #  #####   # #      # #  #      #    #   # #   # ##   ##     # #   #   # ####  ##  # #   #  ##     
        #   ###  ####     # #    # #   # #   #    ## # ##   ##     #  # #  ##   #     # ##    ##  #     
       ## #   # # # #   # # ##        # #     #  # ### #   # #    #       # #     #      ###      #   # 
   ## #       #    #     #     # #  #         #  ####   ## #        # # # #### ##   ## #    ###  #  ## #
###     #  # # #   ##    ##         ##        # # ##      #  #  ##   ### ###     ##      # #    ##  #   
 ### # ## ##   #  #   ##      #  #  ##    #    #      # #  ###       #    # #        #    ###  # # ##  #
 # # #  #  ###  ##       #      #  ## #       #            #    ##    #  #  ## ##          #  #   #   # 
 # ## # #            #### #   ##       ##  #     #        ###   ### #    #    #    # ### ###            
#       #     #  #     #  ##  ####  #### #### #   #   #  #    #   ##    # ##     #   ## #    #          
  #     #    # ##  #   ##   #    #     # #  ##  ## # #          ##    #   ####    #  # #  #  # #  ##    
  #        # #  #   # # #  # ###         ##  ##  # #      #       #        # #  #   # #     ##          
   # #    # #      #     ###   #  #    #  # #    # #     ##    #   #   #   #  #  #  #  # ##   #    ##   
 ##      #    ##  #  #  # #       # # #  # #   #        #   # #     #           ##   #   ###    #  # ###
 #   #    #           ##    #   ##  #  ##  # #    ##     ##             #   ## # #  #  #   ###  #  #  # 
  #     ####### ##  # #    #  # ## #   #  ## ##          #            #   #  #     ###  #    # # #      
  # #     #  #         # # #    ##  #       ## #  #   #    ##    #   ### #    # ###         # ### #  ## 
      ##  #  #    ####   # #      ##  #  #  ## ## # ##           #  #  # # #    ###  #  #   #   #   # # 
       # #  #            # # ## #   ##   #     #        # #      # ## #   #        #  ###        #      
      #            # #  #     #  ###  #    # ##       #    #     #         #       ##       # #    #    
