## #   #   ##    #    # #      #   #  #      #   #####            #    ##      #    #   #   ## #        #        #
 S   #      #              #  #           #     ##     # # ####   ## #         #      # #  # ##      ##   #  #    
       ###            #  #   # ##        ###                      # ###  # #  #     ##    # #     ## # #    # # # 
    # #   #  ###      # ##      ##  #  ###  #   #  ##    #   #  #   #      # # #   #  ##   # #  ####       # ##   
       #   #   #        ## #  ## #        #   #  #    #         # ####     #          #           #        #     #
  #   #    #  # # #  #     ##    #  #  # ## ##    #  #               #    #     #  ##       #            #     ## 
 #   #   ####   ##   ##   # #         #  #   ##  # # #       #  #               ##     # ##           # ####      
## #  ## #  #  # ## # #   #       ###   #   #   #   #   ## #   ##    ##   ##  ## # #            # #  #      # #   
  #  ##  #      # ## #   #   #    ## ##   ####  # #   ###     ###   ## #######         #   # #     #     #    #   
 #     #      ##    ###     # #  ##    #     #   ##          #  ## #             ## #    ###  #  # ##     #       
  #   #  #           #     #         #    #  # #  ### #  #    ## ## #       # #       # #  ###   ###         #   #
 #  #         # #       ##     ##   #   # # ## ##  # #  ##   # #   ##     ##  #  ##   #  ##     ##  ##   #   # # 
  #    # #  #  #    #  #        ###     #       ## ##  #            # #     #        ##           # #   ###### ## 
    # ##    ##       # ### #    #  ###      # #         #  #  #  #    ## # #     #    #      #  #  ### #     # ## 
##                #   ##  #  #  ## #     #   # #  # ## #     #     #    #  ##   #       # #    #    #      #    # 
   # ##   #   # #  #  #            #      ##     # ###     ## #   #   #   #   #   #        i  #      #  #  # #    
  ###   #        #### ## ##### #   #  # #   ### # #  #           #   # ### #  ######        #    ## #  # #        
  #      #  #  ###  # #     ###     ##  # # ##   ##      # ##      #  #  ##   ###    #   #      #  #   #   #     #
   # ##      # #   #       # # # ###          #   # ###                      ####  ##     #      ###    #    #   #
   #   # ##   # # ##   ##     ####     ###    ###  #    ## #     # # # # #  ##  #    ## #        #    # #         
    ##          #   # # ##   # #    # #  #  #   #         # # #        ##  ## #   #         ## #   # #     #    #
 # # #      ## #   #         #   # #     #      ##     #  # #    ## # #     #     ###           #    ##   #    #  
# # # #         #    ##    # ##   #   ## ## #    #      #  #     #  #   ##   ## ###  #  #     #     #  #  ##      
# #   # #   #     ### E#   # #   #              # ##     #  #       # #  ##  ###     #    # # ##            #     
# #   #   #  #   #   #         #    # # ##      ##  #        ##    # ##    ##     i # ## # # #####  #     ####  #  
      ##  ##### ###    ## #  #   ####    #  # ##   #  # # #  ##      ## ## ###      ## #  #  # ## # # # # #      #
     # ##    #       #         ##   ##   ## #  #    ### #      # #  ##    #   # #      ##          # #         #  
     #     ##   #    #  ##  ##                   #    ##    ##  #  # #        #   ##    #  #         #         ## 
       ##  #   #    # # ###  #  ######   # ##   #  #     #  #  ##  # # #    #     ##    # # #  # #  #    ##  ##   
 #  #    # #   # #        ##   ##     #  #       # #      #    #   #   # #       #   #     ###   #  #    #        
#  #       #     # #  # #   # ## ##  ##    #   #  # # ###    # #           ##     # # #          #  ## #        # 
                # #        # #     # #     # ##  ###  #     ##     #  #  ###  ## #   #  #    # #  # ## # #    #   
#  ###  # #  # #  #  # # # #   # #       # #  #  ##    #   #    # #   #  ## ##   ## # ## ##  # # # #       # #    
# ##      #   ##     #      #   #   ####    ###        #   #  E  #     ##    ### #  ### ## # ##    # # ##         
  #     #  #        # #       #       #    # ##   #  #  #  #   #  #    #     # #      #   ##  ## #    ##   #    ##
      ## #          ## #    #    # # # #   ##  #   ##  #    #  #    ##        #     ###     # # #  ## ##       #  
  #  #                  ##    #  # # ### #     # #### ###                  #   #   ## #  ###       #   # # #  ## #
 #  # ##   #  # # #   ## #  #   #  #  #   # ##      ## # #  # # ##       #   #  #         #     #   #    ##  #   #
   #      ##   #      ##    #     #  ##    # # # # # ## #      #   #    #    #   # #   #    # # #  #       #   #  
 #    ##  ####  #    #   #    ##    #    # ###   #  #      #  # # ##  # ## # #      #     #  # #   #       #      
#     # ## #     ####   S    # ##   ##     # # #  ###        #           ##  #      ##    #    # #    #   #  #    
  #  # ## ##  ##         # #    #  ##      ### #  # #       ##      ## #  ## ##   #      #      #     #        #  
##      ## ##      ##     #         #   #  # ## #  # #i #           #      #  #       # #  # #   ### #       ##  ##
     ####   #        #   ##    # #    #####     #        #         ##  #  #    ##       ## # #  #       ### #   # 
#  # # #   #   #        # ## #      #   #### #  #     ##  ######          ## #      #  # ##         # ##      ####
 ##  #  # # #  #   #    ###       ## ##  ##   ## #    ##    #  E             # #     ##         ##     #   #   ## 
#   # #     #  # #  #  # #  #    #          # #   # #    #   ##       #     ##        #   # # #        # ##  #  # 
  #   #    # # ##      #  #   # #  #    #   # #  #   ####      #   ## #         # #     ## #    #########  #      
     # ##    #p #   #    # i#     #   #      ##          ###    ##      #      ##   ### # ###      #   # ##       # 
     ##  #  ##        ### # #   # ##      # ##                 #  #    #  #   # ##        #   #       # #         
#  ##    #  # #      # #       #     #    ## ####  #       #         #   # # ###      # #     ### #      #  ## #  
 #   ##  # # #  #      # #  #   ## #   #   #### #    #### #  #        ###   ##      # #      ##       #     # #   
 #   ##   #          #    ## #  # ## ###  #   #     ## # #  #           ###     # #   #   ##    ##          ## ## 
#     # ##  #   #        #   #           #     # #     ### # # #  # ##   #    #     #  #  ## #      #   #  ##     
#      # #  ##       #   ####  # ####  ##          #   # #  #     # # ####   ##  #            ##   ##      #####  
      # #      # ##   ##        #  ##   # # # #   ##  #     #  #  ##      #      ##   #  #    # #     ## #  ##### 
   #      # # #   #    # #    #     ####  # ###      #      #  # #  ##   #     #     #   ##   # ##      ##        
     ### #   # ##        #     # ###  # ## #         ##         #     #          ##            ##    #  # #  # #  
      # #  # ##  # #     #    #       #  #                   #   ## #  ###    #        ###  ##   #      ##    #   
#      # ## #          #  #    ## #   #  #  #        #      #      ##   # #     #    #  ### #   # #     ##   ### #
 ## # # # ##               ## ## #  #    ###  # #  ##    ###    # #   ##    ##    ###    ## #  # ##  #        #   
      ##    #  #  #  #  #  ### ## ###       #   # #   # #    ##  ##   ##  #     # # # #   ####    # #    #   ##   
 #  ## # #     ##   ## #    #    ## # #  #                     #     #   #  #   #      # #    # # # #       ## ###
   #    #  # #      # # #   # #      #  ## ##  #### #                 ###  # #     #    #  #     # ###    ##  ### 
# #   # ##  # #  ## ##    #####    #         ### ##     #    ##     #  ###    ## # #       # #   #   ##   # #    #
 #  ##  #   #  #  # #  ###   #    #       #     # #  ###      #     ## ### # #   #    ## ### # #  #   #     #     
 #   ##  # #   #    #  # #      ##  #    #   #     ##   #   ## # # #  ##### ## # # ##    ##  # #     ##     #     
  #    # ###  #    #    #       #   #         ###      ## #   # # ##       # #  #  #  #    # ##   ##   #  #   #   
 #      ##  ##  #     #  ##      ##       ##    #      ## #   #   ####       # ##      ### #     ###  # ###     # 
 #  ##                         #     #       # #         # #                  ##        #          ## # ###    # #
                     ### ##  #        ##           ##     #  #   #  ##  ### ##  #      #      #  #   #    # ##    
    # # #        ##   # # # # #    #     #   ##    #   # # #    ###     # #### #    # #      #   ##     # ##     #
    #   #      #     #  #       # #    #      # ##   # ## # #       #           # #    #     #  #         ##   #  
   ## #      #    #   ##   ##  #### #            ####     #  ### ##    # #   # #   #  #    #       #        ##  # 
  # #  ####  #      ##    ##     #         # #  #  ###       #   ##      # #        #    ###  #     # #           
 ## ## # #   ##  #      #   ##       # #         ##   ##   # # ##        # ## #        # #    #       ##    #    #
        #  #     #   ## #  #   #   #    #    #    ## ##  #   #   #       #     #     #       ## #              # #
      # ## ## #      # #     ## ####    # # # ## #  #         #  ###     #           ##        #  #     ## #      
 ##       #     #          # ## #   # #####       # # #  #       ###   # # ##    ###        ##  # ## ### #       #
   #    ##  # ## #  #  # #  # # #           #   #                     # ## # ##     ###   # # ##            # #   
   #     ## # #     #  ##           ###### ###  # ## #  ##  ##      ##  ####  ##   # ##  #   #       # # #     ## 
 # ##  # # #  #         #          # # ##  #   #   # #    # #  ##   ##       #   ### #  ##  #  ##     ##      #  #
#    #       #      #          #  #       ###   ###   ###   #  #          #         # ## #    # ##    # #  #   #  
    #   #  # #  #  #      # # ##  #  # #   #     ##    ##    #   ##   ## # #  #    #   ##    ### # # #        # # 
  ##         ### #     #     #   #     #      #   # ##      #         #  #     #  ## # #      #   ## # ###     # #
    ## # ##   ##  ##    #      #   ##       ##  ## ##   # #### ##   ##    # #    ##          #          #  # ##   
#   ##     #     #     # #   # ##       #       #  #       #    # ### ##      ##  #        # #   ##           ##  
#   # #  #   ##     #        # #### ##         # #        #   #     # #  #  #      #      #    #         # # #  # 
  #   #     #   #    ##    ###    #   #  #   #   #    #     # #     # # #      ##  #         # #  #    #  #   ## #
 ###  # ## #            #  #  # #    # ## ##   #     #   ##    ## #         # #  #          #   # #  # ## ##    # 
 ## #                   ###  ### #  # #          # ###   #  # #   # #   # #    #   #       ##   #  ##          ## 
   #  #          #    ##  # #  ##    #  #  ##    #  #    ##       #    #          ##### #   #  #  # ##  #   #    #
     #     ##      #  #     ###        # #  #  #    #   #  # #  # #  # ####  #  ## #   ##    #  #    ##  #      # 
##   ##      #  ####  # # #  # ##  ####   ##        ## ###  ##   ##   ##  ##      ##  ### ## ##       #     #   ##
#  # #    ##   #  #      #  ## #   ###  #  # #   ####       ## #  # #          # #    #  #   # ## ## #            
  #     # #   #    #  # #            #   #    #  # # #   # ##   ### ##         #     #    ###  ##     #   # #  # #
            # ### #         #   # #    ###         #  #         #  #   #    ####       #  #####   ##     # #  #   
        # ##  #          #  # ## #  #      #   # # #   ####           ##   #      #    #            #  #      # # 
     #     #    #  #   # ##     #  #   ### #  ###    # #   ## # ## #  ##   #####     #    #   ###    ##     #  #  
 ##  # #  #  #   #   #       #      ##  ## #    #                #   ## ### # #        #  ##   #  #          ### #
        # ## #     ##  #     # #  ##  #        #        #    # #   # # #  #   ###  #   #      #   #  #   #  #    #
 #   #    ###         #               # #    #   ### #  #      # #  #   #  ## #     # ## # #    # ##  ## ##  ##   
#        # #  #  # ###   # #     ### ##  #  #     # # ##  #  ## #   #  ##          #  #                  # #      
   #     #  ## # ###   #     #       #         #  # #       ### # #    ##        ##   #            #   ##   # # # 
     # # #   ##   ##     # #             #       ##     ####     #   # # #  #     # #  # #     # #  #      # #    
###   ##  #  ##  #    ###   # ####      #   #       ### #   ##  #   ##     # #  #     # #    #   #              ##
 ##    ##  #  #    #   # ##  #       ##    #   #  #  #   # #      ##      #     ##  #     ##     # # #            
  ## #  #     #          ###     ##   # #   # ##    #    ##  ###     ##      ## # # #  #### # # ## #    #     # ##
   # #   ## #     ###  ##  ## #       ###    # ##  ### #### ##   # ##    ##  #   #  #   ## #            #      #  
    #     # #      #   # ## # ##  #    ###   #  #             ##     ###  ####   # # # #   #     #         #   # #
 # # # #  ## #   #   ##   #     ####             #  #   #     ##    #   #      ##     #       #    #    ##   #   #
 # #             #   #  ##  ### # ##  ##    #   # ##  #     ### ## # ##  #    ##  ###          #  # ##  ###  #  # 
  #  ###    ##   ##       # ## #### ####     # #    #       #####   #     # #   # # #  #     #  #   ### ##  ## ## 
   #  ###  #  #     #       #        #    ######  #  #  ###   #   # #####  # ##  #  #      #    ##  #     # #    #
   #  #   # #   #  ## ###  #  ## ## # ## ##  ## #   #    #           #   # ### #    #       #   #  ##  #  # # ##  
          # ## #     #       #       #   #   ##        ##  #       ##  #   # #      #  #   #  # #         ## #    
# ##   # ##    #   #    # #     #     # #     #  #  # # ## ###  #   #  ##  ##  ###   #    ##   ###     # #       #
 ###   ## #   ##      # ###   ## ##### ###     ### #    #   #   #  ### ##  #  #     #  #           ##      #    ##
 # ### ##   ## #  #  ####     ####    #    ## # #   # # # #     ##   #   #         #  #  ##      #     # ##  #    
#       # #    # #   ###     ##   ### # #  # #     ##                ##    #         #   #    ## # #  ## ##     # 
  #  # ##    # # ## ##   ##   #   #   #      #  #  ## ## ##     # # ##   ##   # #         #     ##           ##   
  #   #           #        # ## # # ## #    # #      #  #   #         #      #           #   #  #      #     # ## 
#  ##   #       #  ##     # ###            #  # #  # ##   ##  #  ##  #  #  ##  #   #      # ####   #       ##     
#  #  #  #     # #  ### #   #    #       #      ## # ####     ###   #   #  #   # # #  #  #  #     # #  ## #     ##
  #   ##         ### # #  #  #     #  ###  ###   ## # ##    ####      ####      # #  #   ##    ##   #  ##### ###  
  # #   # ##  #        #  #    #  #    #           #  #   #    #     ######    #  #     #             ###   #    #
# #      #           #              ##     #  # #  ##      # #  # ## #      ##   #######  #   ###    # #   ###    
    # #   #   # # #  #   #    ##     #  ###     ##   ##          #   # #   # #            # #    #   #  ##    #   
   ####              #       ### #       #   #     #         ##        # #     ## #  #####         #     #   ##   
