      ## ##    #   ###  #       ###  #  #     #        
#S       # # # #    # ##          ### ## #  #    #   # g
 ###  #     # #   # # ##   #  ##  #  # #    #   # #  # 
 #   #  #        #    #     #######            #     # 
### #   #    ##     #    #  # # #        ####   #  #   
#   #      #     ###           # #   #   #   ##  #     
 #   ##   ### #     ### ##      ###  #   #    #  #  # #
     #   #    #            ##     #  #   #            ##p
  #         #        #  # # #             #  #  ###E # 
##  #  #      # # #  #     #  #            ##       #  
 #         ##     #         # #  #  #  #   ##  #      #
gd