###      #   ##  #  #
#S#   #  #      ##  #
#  #       ###    #  
 # # #             # 
 # #         # ## ## 
    ##       #  #### 
#  # #     # ##    ##
 #   #       ##      
#  #   # #     ##    
#   ## # ##  # # ### 
# # ###     ###     #
##  #   # #   #      
 #            # ##   
 # #  #  # #        #
 ##  ###   #    #    
 #  ##  #    ## #    
   ###   #  #    ##  
  #     ## # #   #   
# # #  #   #   #     
       #       #  ## 
 #        ## # # #   
#   #  ##       #    
    # #          #   
        #  #  #     #
   #  #   ###        
    ##    ##     #   
 # #    #          # 
 #  #  ### #   # #   
      ##   # ##  #   
#  #    ##     ##  # 
#### # # ##   #   # #
#       #   #        
# ##     #         # 
    #        #    ## 
#    ### ## #        
###     #    ##    # 
#   # #  # #     ##  
  #####         # #  
  # # #   # #   ###  
     # #  #   #  #  #
   #              # #
   ### #        ##   
        #     ###  # 
   # #    #   #    # 
           #    ###  
   #      ####    #  
  #     ##  ##  # #  
#   ##   ## #      # 
      ## #    ##     
  ##    #         #  
    #    #   #   #   
# #  ##     #    #   
 ##     #        #   
       #   #   #    #
        #          ##
   ## #         #    
  ## ####       ## ##
          ## ##  #  #
   # #         #     
#    # # # #     #  #
     #   #   #       
##  # #   #  # #   # 
#     #### #     ##  
 ###  ###    #  #  ##
    #  #  #  #####  #
 # #  # ## #  #  #   
 ##        #   #   ##
##  #      ## #  #  #
 ###     ##   ## #   
####  #  ##     #   #
 #            ##  # #
        ##    #    ##
#   #   #  #     #  #
   ###   #   #  ### #
     ## #      # #   
   # # # #  ###     #
     #    #    ###  #
      #         ###  
   #   ##     ##     
###  # #     # ##   #
   #### # ## ##      
         # #   ##    
 #     #    #   ## ##
 ###      #    #    #
       #    #    ### 
  ##    ##  #  # #  #
#   # ##   # ##      
      ## ##     ##  #
   #     ##          
 # #     #  # # #   #
     #  ##     # #  #
#  ###         #   # 
 ##    #      #   #  
##    ## #  ###    # 
  #     #       ###  
##    #   #    #    #
#  # #  #      ####  
   #        ###   #  
 #  #    ##   #  ### 
    # #         #  # 
 ##  #  #   # ##  # #
  #  ## #     #    ##
  # #    #   #      #
 #   ###  # ##       
 #  # #    ##  #     
#  ## #     ## #  #  
#    # ##   ##### # #
  #        # ##   #  
#   #   #    # #   # 
  #   #    #  #  #   
 #   #  #      ### ##
  #  ## ###   # #    
 ## #     #   #   #  
#     #    #   ##    
#        #  #    #  #
 ###    # ###  ##    
  #     #       ##   
 ## ## #  ## #   #   
     #       ####   #
   #     #  #   #    
  #  #  #    ###  ###
  ##      # ##       
  ###     #   ##  #  
   #     ## # # # #  
##     #  # ##       
#      ## # # #   # #
    # #  ### ### #   
# #    #  #      ##  
     ##  #     # ##  
# #          ##  ##  
# #          # # #   
       #       #    #
         #  #   #    
   #   ##    #  #    
      ##    # #  # # 
  #     #    ##      
    # #    # #  #    
  # ## ###  ## #     
## #   #  #   ### ###
      # # ####  #### 
 ##  # ##    #    #  
  #      #     #     
  ### # ##           
###  #  #  ##    #   
  ###  #   #         
#  ##      # ##    # 
#  ####      #       
    #    ##  # #  #  
       #      #  #   
     #               
 ###   #      # ## # 
    #   #    #       
  # # # #      #     
# # #     #   # ## E 
 # #     ##  #  #   #
          # #   #   #
 #        # #   #   #
 ##  #  ###  # #     
   # #  #  # #     ##
   #     #  #     # #
# #        #  #      
  # #   ##   #     # 
      #     # #    # 
 ###   ###    #    # 
      #             #
 #  ##   ## #    #  #
   #                 
 # # #    #       ## 
 ## #      ## ### #  
##   ## #    # #     
   ##     ####       
#       #  # #      #
  # ###   #  ##      
##  ##  #     # #   #
 ####   ### #      ##
  #    # ##   # #   #
 #           ##     #
  #   #  # ##### #  #
