     #  ##   ### ##   ## # ## #     ##  #   
#S    # ##    #   #      ####   #    ## ##  
       #  #     # #  ##    ##          ##   
  # #  #          ##   # ##             ##  
#      ## # #        ###### ##   #   #    # 
  #   #       ###    ##     # #  #   ## #   
       ###    ###   # # ##      ###  # #    
    #   # #    #  #  #          #   #  ##   
 ##    # # #####  #  #  #          #  #     
    #    #   ##    #            #  # # #  # 
 ###   ## #  #  # # #  # #      ## #  #    #
  ## ## # #  ######       #    #  ### ##   #
 #          # ##  #   # #     # #    #    ##
### ###      ##  #  # #      #  #       # # 
###    #      ##    ## #       #       #  # 
 # #      # ##    ##      #  ##     ##  #   
#         #  #   #   ##      #  #          #
     ###    #     # # #        ##   # ## #  
  #              ## #  # # ##  #   #       #
##   #   ##   # # #      ## ## ###  # #   ##
 #  # ##           # #     ##    #       # #
   # #   ####       #     # #### #   ## # ##
    ## ##        ###  #         #   ##  # # 
#   #   ##   #   #  #  ###    #    ## #     
      ##         # ###                 ##   
 #     #       #       # #    #     #       
   # ##   #  ### #   ##    #  ## # #  # ### 
#  ##      # ##    #  #   # # ##   # # ##   
 #     #  #    #  #      ####     #   ##    
     #   ##     ##  #      ####   ## #  ### 
# # # #     ####    ###      # ###    # # # 
   ##     # #   # # #       ## # ##  #    # 
  #    # ##   #  ###       # #    ####      
    #  ###     ##   ####          # #  ##  #
 ##  # # # #   #         #    #    #  ##  # 
# # #    #   # ##      # # ##      #    ##  
 #  # ##         #   ###  # #     #         
 #   #                 ##  #  #  #   ##  #  
 #   #       ##     # #  # #      ## ##  ## 
 #        ##  #   # # # ## ##      ## #  #  
 ##    # #  # # # # #        #    #     # ##
# #  #   #   #    # ###   #      # #     ###
 ##  #       ##     #  ##           ######  
# #        #   #  ###       #      #       #
  ##    ##    #      #    ##  #      #   # #
 ##  ## # #  #   #  #   # #   #  #   # #    
#   #  #  ## #  # #    #              #  #  
      #  #    #     # ####        ##      ##
  ## #    #   #      ### #   #      ###    #
##    ##    #            ### ##    #    ### 
##      ##   #   ###  # # ##    #   # #     
##     ##  #     # #### #        ##    #    
##          ###  ### #      ##   #  # #   ##
##   ##     ##       # ##     ##          # 
    #  ###   #    #   #   #        #       #
#  ## #   #     ## #        #####    #    # 
  # ### # #  #          ###      #   ##   # 
             ### #     # #     #   ##       
 #   #    #   #  ####     #    #     #    # 
              #####   #          #   #      
   #    ##               ##       #   #     
     ## #   #  ##  # #  #  #  #     #  ###  
 # ## #      ##     ##  # #          ##  #  
  # #   # ##  # #  # ##        #       ###  
#  #   ##   # ##      ##    #   #  #  #    #
      # # #  ## #  # #   # #  # #      # #  
##   ## # # ## #    #   ## #    #  #  # #   
               #    #       #  #        # # 
  # # ##  # ##     ##      #   #  # ##      
   #  #    ## #  #   #   #  # #       #     
####      #       # ###         #   #   ## #
# ##     ## #  #  # ### #       #    # #   #
 #   ##   #   ### #  ### # # ##  ####       
#   # #            # ## # # #     #  #  # # 
 ## #    #       ###    #        ##   # # # 
    ##  ## #      ####    #          #   ## 
##      #      #    #    # ##    ####  # ## 
    #       # # # # # # #     #   #  #  #   
 ## ##  ## #   #  # # #   # #       # ##    
##   ##  #    #  # #   #    ##  ##  #      #
  #    #####  #       ### #  ##    #  #  #  
 #  ##             #  # ## # ## ##          
  #  ###   #  #      #    #       #         
  #  ###   ### #      #     #   # ## #  #  #
#  #    ##   #       #  #   ##  # # #    #  
  # ##  #   #  #  #  #  # #     # ####   ## 
 # #  ##  ### ##      #       # #  #E   # # 
#   #  ###     #    ##     ##  #    #      #
       #  #  # # ## ##    #  ##       # ## #
#     #    ## ### ##   #        ## #    ### 
  #  #     #     #          #### ## #  #   #
#  #  #   #    #   #    # #    #    ##   ## 
  # ##    # #   #       ###   #   #  #   ## 
 ###  #  ##       #   ##    #  #     #   #  
#   # #  #       ##  ##  #       #   # #  # 
  ##        # ##     #    ###     # #   #   
    ##    #      # #   ## #     ##    # # ##
 # #   # #                #    ##    #  # # 
#   ##              #### ###  #   #  ##     
   #        ##     # ###     ##  #  ###  # #
##  ##    #              #      # ##    ##  
 ## ##     #    #   #   #   # #      ## #  #
 ##   # #     # ### #   # #   #   #     ## #
  #      # ##  #       ##   #   #      #  # 
   ### # #       ## #   # #   #      ###    
 # ##  ###  # # # ###  ### #     #  #  ###  
 # # # ### # #   #      #       #          #
 ###      ## ## ##         #        #    ## 
#   #  ###  ##    # ## #    ##  ###    #    
  #      # #             #    ###   ##  ## #
 #   # #  # ##  #  # #    # #    # ### ##   
##  #      # #       ##   #   #   #         
 #  # # ##   #### #   # #  ##    # ##  ##   
  #    #  #  ## #        ####   ## #    ##  
   #  ####   #   ###   #        #         # 
  #  #  #       # # # #      ##        ##  #
        # # ##         #  ##  #         ## #
 ##  #      #   ##    ##  #   #  ##   #  # #
       #            ##  #    # # # # #      
   #      # #           #    #       #   ## 
      # ##  ##   #          ### #      #   #
   ### # ##     ## # #   #    #          ###
   #         ## #    #            #      # #
  #  # #  # #   ##   ## #    #   #        # 
 # # #             #    ##   ## ## #  #   # 
#  # ## # ##        #  # #   # #    #       
# # # #   ##       #   #  #  #### ## #      
#   #  #       ##  ##      ## # ## #      ##
           # # ## #   # ## ####       #    #
   #  #    #       #   #   # # # #    ######
  # ##   #   #    ##           # ##  ## ## #
  #   #    #       # #     # #    # # #    #
 ##  ##  #  #  ## #      ##     #   ##     #
#   #  # # #  # #   # #     #    #     ## # 
  # #  ## ##  # ##       #    ## # # #  #   
  # #####   #  ## #      #    #  ## ##     #
    #   #   #  #    ##   # #  #   ## #  #   
    # ##  # # # #   ##         #     #      
  ##  ###        #  ### #      #     #   # #
#      #  # # #  #  # ##     # ## ##   ##   
# #       #    #     #      #  #    # #   # 
# #### # #  #        #   ## #      ## #     
     #     ##                      ## #   # 
 # ## ##  #    ##    ## #  # #              
 #   #   ###         # #     ##        #  # 
# #    #      ##  # #       ###    ## ###   
      #    #  ##  # ##       ## # #  #     #
#       #    #       #        #         ### 
 #  #      #  #    #         # ####  #  #  #
 ## #     # #  #    # #   #      # ##    #  
 #   #  # #   ####   #                #    #
  #   ##    #  #     #   ## #     #  ##  ## 
# #  ## #  #       #            #        #  
   #    #   # ##            #    #       #  
#    #   # #  #    # # ##         #   # #  #
 ##     #    #        # # #  #     ## ##    
 #             ###      #          ###   #  
    #         ###  ##     #    #  # # #    #
#     ##  # ##         #   #   # # #    # # 
###   ## # ### # ## #         #  ###        
#           #  # ##      #   #        #   ##
           ## # #   #     #     #   #       
  #  ### #    ##     ##       #   ###    #  
#  #  ## # #    # #   #          #  ##      
  ###      #  ##   #  #   # ##  #      #  # 
   #     # ##    # #   ##  # #  #  #  # ## #
  ### #     #### # #    # #   #  ##    #  # 
 #    #  #  ##       ##  ###        ####   #
#  #  # #     #   #      ## ## #   #  # #   
#   #      # ####  #   #  #  # #   ##   ### 
  # # ###    # #   #    ##    #    # # #    
#   # ## # #           ###  # #   #  # # ###
##     #   #       ##    #  # #     # #  #  
 ##  # ####     #    ##             #  #   #
#    ##        ### ## #### # #    #  # # # #
# # ##  ## #        # # # # # #  ##   #  #  
# #      ## ## #  #      #  #    #     #   #
# #   #       #      ##    ## ##     #     #
 # # ##         # ### ### # #   ###     ##  
         # ########   ###    #     #       #
    ### # #  #  ##  # #       # # #        #
  #  ## #  #     #  # # #   #     ## # ## # 
    ####  # #    # #    #    ## ###     ##  
###           ##  ##  #       # ##     ##   
##  #### # #   ##       # #  ##     #  ###  
    #    #    ##   #      # #    #  #    ## 
#    # #     #               ##  #    #  # #
     #### ## # #            # ##  ##  #   ##
## # # #   #         #     ###  #  #    # ##
 #            # ##      # # # #  #    # ##  
