    #      # ### ##  #   #  #   #    #  #   #  #     ## ###  #    #    #    #   #  #  ## ##  ### #  ## #    #
#S  #           ##   #      # #      # # ## #   #           #    #             #            #  #  ## #  ##  #
  #  ##        #     ## ##     ### #    #   # #  ##  #   # #       #   ###   # ##      #         #    #     #
    #  ##      ##  #   # # #     ####    # # # #   #  #     # # # ## #     # #  # ## #      # # # # ## # ## #
##   ##   #     #   #        #  ##  ##     #   ## #  ##   ##   # #   # ###  ##   #  # # #  #    #  #         
   #     #          #    # # #  #  ##          #          #     #     #            ##  ##      ## #   ## #   
 ##   #   ##  # ## ##   #   #  ###            #  #  #  ##  # ###    ## #  ##      ###  # # # ###  #   ##   # 
      ###  # #    ##   #      #   #   #   # #    ###    # ##             ####  #     #        ## ## ##       
# # #      # #   ## #  #  #              # ## ####  ##     # #    ## ## # #  #   #   ##  #                   
  #       ## # ##  ## ##      #     #   #     #  ##   ## ### #  # #     #   # # #  #           # #  #  ##  ##
  # ##   #  #  #     ##         ###   #   #   #    # # #    #  ##               #  ##      #   ## #     ## ##
 #  #     #  # #  ##### #      #   ##   #       ###      #  ##  # #            ###     ## ###      # ######  
     ##        ####    #      ####   #      # # ### #    #      # #   #         #   # #  #  ## #  #   #  ## #
  #      # ## #      ##    #    #   #   # #        #          #  #     #  #  ## # #    ## ###     ##    # #  
#      # # # #          ##    #    ## #   ######  # # #  #   #   #     #   ## ##      ###   #      ##       #
#   ##  ##  #  #    # ##           ## #        ## ###  # #   #  ###     # ##    #  #       #     # #  #     #
        # ###  #         #   #                       #     #      #   #             # # #   # ##  #   #  #   
  ##   #  #  ##   ##         #   #        #    # ##  # #        ##    ##  #    # # #     # #     #   # #     
#     # #    #  ##  ####    ##  #    #    #  #   #  # ### ###   #     #    ## #  #    #      ##  ## # #      
##   #    #  #    #      #   #   #    ####          #    ### ##      #         #       ##### #     #      # #
   ##   #  # # ###    #  #      ##    ## #  ### #  #    ### #    #          #    #     ##   ### # ##    #    
###  ##   #      #    ##   #  #   ##           #       #     #      #  #    #      #   #   #    #  #      ## 
 # #  #   #   #   #  #       #   ##   #   #    #  #   # #  #  # #  # #   # #  ##    ##     ## #  ##    # ### 
#      # #  #  # ##     ##   # # #  # #     ###   #   #    #   #   #       #      # ##  ## #     #    #   # #
   #   #    #   # #    #                         #  #     ###  #  ###     #   #  # # ##    #     ## #  # #   
  #  ###    # # #  #    #  #      #          #  #   ##        ## ###         #          ##  #     ##    #  # 
#   #  ## # ###    #   # ##     # #  # #   #    #       #    # #  #        # # ##      # #  #      ##     ## 
    #   # ## #   ## # ##   ## #        ##         #      #        # ##     ##    # #   #   # # # #     ## ###
 ###   # #  # #         # #   #              # #   #   ##      #   #####   ## ###   #  ###   #    #        # 
# #   ##    ##  ### # #          # ##    #     #     ###  # # #      ### ##  ### # #   #    #  #  #        ##
       ##   ##      ##    #  #    #  #    ###           # #####   #          ## # #   #     # ### #    #    #
    ##   #####  #  #   #   #                  #     #  ##    #  #   ##    ### ##     #  # ##       ####      
 ## #      ###  # # ## #      #  # ##      #  # #        #    #  #  #    ###     #  ###     #     ##        #
   ##   # ## #    #      #    #  #  ####   ####       #      ## #   #  # #    #   ##  #  # ###      # # # ###
  ### #  #   #    ### #    # ##      #   # #  ###                   # # #####   ## #    #####            # # 
#   # ##       ##      #   #        #   #            # #  ##     ## #   # #    ###          # ## #  #   # # #
## #  #    ##      #     #          ##   # #  #  #    #  #  ## ### # #   ##                            ##    
#  #              #   # #  #   ## # ###   #    #  #       #       # #      #   # #  #    #     # ##       #  
      #     ###        # #      ###  #  ### #      # ##  ###  # ##  #     ##        #  ### #    ##     #     
         #      ##       # #    # # ###  # #  #    #    ##     # #  ###   #    #  #       #        #    #   #
  ## #  #     #  ##        ###    #    ## #         #  ##  ##     #   ##  # #####     #   ##      #          
        #  ### # #        #    #         ## #    # #     #    #  #        #   #     # #  # #  #     #        
   # # # #       #  #  # #    #       ###  ####    #      ### #      #   ## #  ##      # #  #### #        #  
     ##   #  ### # #    ##    ##  #    #   #    #   #      ##      #           ##   ### #  ##    #    ##    #
  # #          #    #  ## ####     #   #   ##       ##      # #       # # #    ##   #     #       ##    #    
   # #      ## # #      ##    # # #  ##        #           ##  # #  #          #     #  # ## ##      # ## # #
   #  #  # #    ##   #  #  #     ### #  #  #   ##           # # #   # ##    # #    ##  # ##  # # #     ###  #
# ##    #     # # #   # ## ##   # # #   #  # #    #  ##  # #               # #       # ## ###      #   ###  #
    #      #### ##     ##       # # ###  ## #       #    # ##          ##    #      #####  #    #   #     #  
#  # #   # #  ###       ##    #   ##  #     #         #   ##           # #    # ## #      #               ## 
 ##  #      # #  ###     #        # #   #  ##  # #  #   #               #  ## ###  ####  ##    # # # ###    #
 #    #        #          # ##  ##  #         ####    #      # #  ##    # ## ##    ##   ##   #     #     #   
####   # #   #        #      #  #   # #  #     #   # ##  # #   ##  ##   #  #     #     #    # #  #   # ###   
#        #   #     ## #  #   #  #     #   #           ## #  ##    #    ## #  # ###  #   #  #     #  ###  ## #
    #  ### ##    #    #         #  #        # #        #   # #  #              #      ##  #  #    ## ###    #
  #  #   #  #    #             ###     # #       #     ###       # #  ##         ##  #   #       ## ###    ##
    # #    #   ## # #          #     #   # #       ## ####  ##  #  ##    ##  #     #     # ##     # #   #   #
 #   #      #   # # ## #  #          # # #          # ##      # # # ##        ##   ###  ####  ##   #      #  
   # #     #        #  #  #  ###    #   ##      # #    # ##     #    # #   # #   ###     #    # # #  #   #   
###   #     #   ###   #   ##     ## #    ##   #       #     ##    #           ##   #  # #       #  ##        
 # #    #     # #  ##    #      ##  ##### #        #     #   #          ### # #  ## ## ###         # # #    #
#    ##    ### # ###             ## ##  ###  #        # ### # ### # # #  ##    ##  #    #         ## ##   ###
   ###  #        # #   ###   #  #   ##  #  #  ##   #  #      ##        # #   #  ## # #  ####       ##  ## #  
##        #    # #      #     # ## ##  ## # #  #   #  ###  # ## ### #    #    # ##       ## #    #  #    # ##
#      ##  ###          #    #  ## # ##        ##      # ##   ####    #   #  #   # #     # ##  # #   #   #   
##  #   ##       # # # #   #     ##     # ####    #   # ##      ##  ## # #  ##  ##            #     #       #
  #     #   #   #     # ###  #    # #  ####         ##  # # ##  ####  ###  ## #      # ###        ###        
      #  #     #  #  # #     #         # # # ## #          ## #  #  # #      #      # # ##  ## ###  # ## #   
  # ###      #   ## #           #  # #   #  ##  #      # #   # # # #   #     ##    ##       ##   ###    ##   
  ##  ##  #     ### #   #   ###        # # #     # #      # #         #      ### # #  #  # # #  #  #    #  # 
     # #     #  # #   #     #         #        #  #     #    #     ### # ##     #   ##         #  # #   ## # 
#       #   #  #  # #          # #   ####     ####    #      ##   #  ##    # #    ##              # #  #     
#  ##    # #   ##  # # #      ##   # # #          ## #       # # #             ##  #  ##     # #  #       #  
         #  #  #  ###    #  ##      #      ###   # ## #        #  #    #  ##  #    ## ### ##  #   #     #   #
   #           #             #    #      #            ## ##         #         #   #  # ###   #     # # ##  ##
##  #  #                ## #  ##             #     #     #     #   #     ##  # ####      #     #    #### ## #
     #  #  ###      ## #   #    ##    ##   #      ###   # # #       #     #  # # #   ##     # #  # ####      
 #     #    #   #     ## # #   #     #          ##      #   ##    ##  #   #     #  # #  ##    # #           #
   ##    ###  #    ## #             # #  ## ######  ## ##       #  #       # ##   #      #                 # 
  # # #     # #     #      ## #      #      #      #      # # #  ## #    ##       #         #   ###  #     # 
    # # #     ########## # #    #  # #     #  ####  # # #   ## #     #   #  # #  #    ##    # ##  #      # # 
##      #  #  #  ##               #     # # #    #         #   #   #   # #  # #  #  #      #    #     ###  # 
    #  #    # ###          ## #  # #           #   ### #   #      #  #  #   ###  ##  ## ##  ##    #      #   
   #       ## # # ## #  #   ##    ##      ## #   #   #           # ####    #  #     #####    ###   ##      ##
# # #     #   #        #  #       #  ## #  #          ##              #  # #   ## # ####  #  ####  # #    #  
       ## #   # # #    ### #  ##   # # ###     ###  #  # ## ###   # # ##         # #    #   # #   #   ##     
# ### #  #    # # #   # #####   # ###       #    ### # # # #         ####        ##  ##   #       #         #
  #     # #     #  #   #  #   ##     ####     # ###   # # #     #   # ##   #   #              ## #      ### #
## ##         #####   #      ## #  # #         #   #     #   #     ##   # ## ### #  #   #   ####   ## # # #  
 # ## #   #   ##      #         #  ##   #  # # ####   # # #    ####    ##   # #  ### # ## ##  #    #   ##   #
   ##   #          ####   ## #          #   # #       # #   #     #    #  #      # ##  #   #     #           
## #   ## ## ##  #         #  #         #      #    # # # ## #   # #   #   #   #  #   ## # #####          # #
    #  ##      ##  ## ##  # # # ##     #        #### #     #      # # #    # ## # ###         ##  ##      # #
##  #  ### ###         # ##  #    # ## # #     # #     #    #     ##    #             #   # #  #             
#   ##   # #  ####   #    #  #   #      ## #   #         # # #   ##  ### # #   ###  #  ##        ##    # # # 
  ###       #  #     ##             #       ###  ###    ###        #        ##          # #  # ##     ###    
  ##         #       ## ###                 #       #  # # ###           # ##   ##     ##        #    #      
  #    #         # # #      #  #     ### #       ###       # ## #     # # #    # # ####   # #####     # #   #
      ##                          #       # ####    # #    #  #    ## #   #  #    #  # ##  # ###### #   #  # 
  #   # ##      ##  ###      #      ##             ###    # # # ##         # ###       ##     # #   ##  #  # 
  #       #     ###                 # #        # #      ####  ## # # #  #  #       #   #     ## ##     #  #  
#   #   #  ###   ####     # ##  #                   #    #  ##    #  ###   ##  #  ###    #  #    ##  ## #   #
   ##  # #  ## #  #  ##    #    ## ##  #  # # ##     #     #      #       ####   ## #    ## #   ######  #  ##
     #     ##                #    #      #          # ##      # #  # #    # ###    # # #   ## #   #  #       
#     ##  #   # # # # #   ##  ##    # # ##       # # #  ## #   #   #  ###     # ##      # #  #    ##  #  #   
                          #       #     #  #  ### # ## ##         #   ## ###  #   ##     #    # #    # #   ##
   #     ##  #        #  #  ###  ## ##    #  #     #          ## # # ####  # ##  #    ##        #    ##    # 
      #            #   # ## #    # #    #    ##   #   #    #  ##    ## # #     #     ##   # # # ###   ## # ##
 #  # ##  # ##  #     ##   ###  #      #   # ## #   #   #  #   # ## ## ##    #  #   #####     ## # # ##    # 
  #  #       #    # ##  #               #  #  # #       #  # #  #  ##   #    ##    # #  #     #       #  #   
     ##  ##  #   # # ##  ## ##    #         # ##     ##  # #  # #   #  ### #   # # # #     # #      #  #     
# #  #        #  # #   #    #     #        # ##  #  #  # #  #    #        # #         ##   ###  ##  #   #   #
  #     #     # # #    #        # #   ## # ##  ###  #    #   # #       #  #        #    #   ## #   #       # 
###   # #        #     #####         # #     ####     #  #     ##    #  # #       # #       ####  # #  # #   
  ### #       #    # # #   ##           #   # # #   # #     # ##  ##   # #     #  #  #       ##  #      # #  
##         ##   #       # #   ## #  #  # #  #      #          #  ##   #   ### # ##   # ###    # #  ### # #  #
       ######    #   ## #  #   # #  #    #   ##   #  #  #  ####  #           #     #   #      #  #   ###   # 
##    #      # #  #  #  #     ## # # # #  #   # ##   ##  # #             ##  #       ### #              #   #
  # #  # ##      #  #     #  #      #     ###  #      ## #    ##  #  #      ####   #  #  #  # # # ## #   ## #
 #  # #    ###     #        # #  # ## ###     # #  ##     ###   ## #     ##     #####   #   #  #           ##
   #     ## #            #       #         ## ### ##  # #    #   #   #  ## # #       # #          #  #  # #  
# #  ### # # # # #    ##  #  # #   ##   #        #      #     # #   ##  #    ##     # #  ##     ###   ##   # 
#  ##            #    #  #      # #   #            #   # #      #    ######   #     #     # ##     # # ##    
    #  #          # #      #  ## #  #   #     #     #     #   #     # #   #   # ##  #       #                
#     #    # #    ###    ## #     #   ##   # ## ###  #     #    #  ## #         ## #     #     #    # # ##  #
   ##  #    # #       ##    # #  #  ##         ##   # #     ## # #   # #      ## # #       #     ##  # ##    
          #  # ##   ##  # ##        #      #  #   #     #  ##  #  # #  #      #  # # ##      #       # ##   #
 #          ### # ###  # #  # # #      # #  #  # # #     ##        #    # #  #  #  # #   #           ### #  #
   # #      # #        #     #  #     #    ###      # #   #   # #      #   ####      # #  ###             #  
  ##      # # ####     # # #  ##      #   #  #  #  #      ###  #      #      #   # #     ####         #  # # 
#          #####          #    ## ## # #     ##          #            # #         ##    #     # #   ####   # 
#  ##     ### #    ### ### ##     #      ## #  ## # #               #       #    ### #  #    #  # ##  #     #
 #  #      #       ## ###  #          # # ###    #        #  ##      ##  ## ##    #  ## #    #        # #    
 # # # ##   ##   ##    #      #     #       # #    #   ### ## #### ### ###      #  #      #         #   ##  #
  ##  #  #            # ### #              ##   #   #      #  ##   # #  ### # #    ##       # ##    # #  ##  
   #     ##    #      ##   #   #           ###   # #  ######  #  ##  #  ### #    ##    ##    ## # #         #
#           ##     #     # #     # #       #   #  ###    #      # ##      ###   # ##   # # # # #  #   #    ##
#   ###     #    # # #   #   #    #    #  ###     # # ####    ##  ##         #     # ####    #        ##     
      #    ### # # #      # #  #     ##  ### # #  #    #   ########   #         #  ## #  ## #  # ###  #     #
    ###        # #   # # # #         #    ## #### #  #            # # #     #                #        # #    
   #  # # ### #  #  #        #  ## # ##  ##  #  ##  ### #     ##  #   #  # #    #   ##          #    #  #  # 
   ###      #     ##   # ## #    #                    ##       #       ##       ####      #     #     #  ## #
   # # ##     #       #  ### ##  #       # # # # #   ## ##  #          #         # # ## ##   #  # # #     #  
#   ###  ##      #   #   # ##      ## ##       ####### #           #   # # #  #    #    # #    ##        #   
# # ##     #   ##     # #  # ## #     #   #      #  # #   #  # # ### #      # #    #  # #             #     #
  #   ##   ### ##  ## #      ##  # ##     ##        ###   ##   #     ##   #      #  #      #  # ## ## #  #  #
#       #  #     ## #  #  ## #   ## ###  # # # # #     # #     #         # #     #  # #    ##    #  ##       
     #     # # #    #  # #         #        #  #        #   ## #### #  ##  #     #        ##                 
 #      ##    ###    # # # ## ##      ## # # ##           ###    #  #### # # ##        ##  # #  #  #  # # #  
#   #   ###  ## # #   # ##   #      ##   #      ## #        #       ## #   #             # # ### #   ## # #  
### #    # # ## #  #  #   # #  #   ##      ##    # #  ######      # ###  #  # # #    # #  # ##  ####      ## 
    #    #   ##     # #   ##    #  #      # #    ##    #     ## # #       #  # # # # ##     #  ##    ##      
#  # ####  # ##       ### ##     ##  ##    #    #       ## ## #   ##    ##   #          ## # ## #  # #  # ## 
 ##### E  ##  #          #          # ##   #   #   #     # ###  #       ##  # # #  #     # #  # #      #  #  
##   #  #  #    #   #    # ##   # #          #      ###  #   ######  # #  #  ##      #   #        # # #      
 ##   ##    ###          #     ## #     #  #  # ## # #  #  # #  ##     ###  # ##   #        # #       #      
 #           # #          #  ####   #     #        #  #    #   #   # #   # ##  # #     ## ##          #      
           ####### #   #                #       # ###   #    #            ##  ##  # ##            #      # # 
 ##  # ####     # # # #  # #         #  #     #   ##    ##       ###   #   #       #    #  #   #  #   #    ##
     ##    #  #       #       ## ##  ## # # # #   ###       ##  #   #     #    ##  #   #  #  #  # ##     #   
 ## # #    #   #  #   # ##    #   #   ##    # # ##### #   #   #### ##  ##         #     #      ##   #  # ## #
  ##  # # ## ##     #  # #    #            ###     ## ##     #       #     # ##  #   #      #  # #     ######
 #   # # #  ####  #      ##            # #        #  # #  # #   ##  # # #   ### #   # ##   #  #  # #   #  #  
 ## #        # #        #   # #    #  #  #   ##  #   #   #          # ## #  ##  #  #  #   #   ##      # ##  #
  #     ###        #  ###  ##   # # #         #  #   ###    ## # ###       #       #      #      ##  ##      
#      ####     #      #  #   #            #           #        #        ##            #     ##  #   # ##  # 
  # #   # #      #          #   ##       ##      #   #      ###   #     #    # #     ## #          #      ## 
 ##    #    ##  #    #    # #   #   ##     #   #      #  #      #        #        #   #    ##             # #
 #        ##      # ## # # # # #       ## #   # ### # #    ##   #  ## # #  # # #  #   #  ##      #  #   # #  
     ###    #    #####               ### #      # #                 #  ##      #  ##       #  ### #    ##   #
#        ## #  # #   #    #    ## ## #   #       #   #   # #### #     ##   #  # #  ##  ##  ##   ## #        #
#    #          #               #  #              #   ##     ##    #    ###   ## #  ### ## ##  ####      ##  
     #   #           #    #   ## #        #  #   ###   #  ###          #     ## #        ##           # #  ##
 ## #    #    # # ### #       #            #      ##  #   # ##  ##  #      ###     ##  #    # ##  # # ##   ##
 ##   #  #######  ## #  ### # ## # ###     # #    #     #      # # ##  #    # #   # #        #      #     #  
#          ##  #    #  # #       ##   # # #       ##   # #  ##  #         #   ##     #  # # #          # #  #
 # ##     # # #   #    # ## #   #   #  ##  # # ###     ####   # ##   #### #    #    ## ##     #### #    #  ##
     #    ##        #  # #     #   ###  # #      #     ## ##  ##       # #  #  ##  #  #####      ## #      # 
    # #     ##  # # #  #   #    # #      ##      #        ##   # ##  ## #  ### #     #    #    #  ## ## # ## 
  ##      ## #  ##  ##    #       #    ## #   ##        ##       #     #  #     # ##  ##     #  ###      # ##
 ##### #          ###       #  ## #       #  # # # #  #             #  #      #      #  # #     # # #  #     
    # #          # #    #    ### ## ##   #  # #            ###  # ## ### #        ##   # #   # ## # ##       
   #  #       ## ## ## # #   # # #     #     # ##   #  #    # #  ##  #  ## ##    #     #    #   #  ##   #    
  # #    #    ## # #    # # ##     #  #                 #      ## #  #     ### #### ### #    ### ## #  ###   
 ##### #  ###           #  #  # #    ###  #    #   #     #  #    #    #  #   ## ## #    #  ###        # #    
 # #  #   #   # #       ## ##           #  # #      ##  ##   #   #  #   #  ##  ####      #   # #      #      
 #      ## #  #  #     #            ##    #### #     #    #    ##  # #            #      #               #   
#   ##     #       # # #     #       #   ### ##  # ####     # ## #     ##          ##       #  # #  #   ##   
 #  # #  #      #  ##            #  # ##        ### # #  #      #  #   ##        #   #   #               # # 
# # #    # # #             ##   #   ##### #    #     #  #      #       # #   # ##    # #         # #   #   # 
    ##    ##                   #  ##  ##  #   ##    #     # ##   ##       #   #      #  ###    # #   ##    ##
   # # #  ##   # ##  # # #         ## #   #  # #  #     #   #      #### #  #  ## #  #   ### # #   ##   #   # 
  # #    ###  #  # #  ##    #   #   #   #   ##               # # # # #     # # ##  #    #      # # # #  ## # 
#  ##    ##  # #  # # #  # # # #  ##  #  #   #  ##  ##  #    ##    ## # ##   # # #      #   #       #  #  ## 
  #    # ##         ####   # ## ##   # #    ##   ##       #   #  #  # # #          ###      ##   ###   ##    
      #  #   ##       #    ##    #  #  #          # ##   #  #       #  # #   # #       #  ##     #  ##  ##  #
   ###     #  ##  ## ### ## ##           #  #    ##  ## #     #   # ##    #  ##       # ## #   #   #     # # 
