   #   ### # #  # ####        #    ## # # ##  ##   #      #  ## ## 
 S#  #      #   #     # #     ##    #  ### #    ###  ##    ##      
 #  #  # # #        #  #       ##   #  #  # #         # ## #    #  
#   #    #     # #      # #  # # ####    #     #          # #  #  #
  # #   #    ##  #  ########  ###    #       #   ## #  # #####     
###     #  # # # # ## #    #    #   #  #        # #   ## # # #     
   #   #   #       #      ###  # #  ## ###  #  #  ## # ####   #    
#  ##       #     #  ###    #    #    ##    ## # ###   #  #### # # 
    #   #      #    #    #      ###    #   # #       #  #     ##  
   #  # #  #   #                ###  # # ###  #    ###  #  ##      
#    #  #### # ##     ## #        #     #   #        #   #  #     #
# #       #      ##     #  #   #  #   #   #          # #  ##  #   #
    #  #  #  # #    #  ##   # #   #   #  #  # ### #         #  # # 
  ###   # #   ## #  ##     ##  ##  # #   #        #   #  #     #   
  #  # #   #   # #   # ##   ###  # # # #   #   #  ### # ##    ####
 #  ##         #  #    #  # #     #        # #    #  #       ## ## 
 # # # #     #   #   ##  ##  ##  #    #  # #    # #       ## #     
       # ##  # ## #     #   # #  ##    #   #  # #        ##     # #
  # # #     #  ## ##   #           #     #            ##  # # # ## 
 ### #   ## ###  ##  #   ##  ##      ###   #    ##      # #    #   
 ### #   # #  #     #  ##      ####           #     ###  #  # #   #
 #   #     p  ###  #    ##            # #    #  # # #### #    ## # #
 # #    ###   ##   # #       # #   #   ##   #    # #          #   #
#        #   #  #   #  #   # ## #     #  # #     #   #             
    ###         #  ##     #      #### #   # #  # #   #        #    
  #          #      #   #     #    #       #      #               #
#  #     ##   # ##    #    ###                # #     # ##      #  
   ### #      #   ## ##  #    ###   #### #   #    ##     ## #    ##
#  ###         # #     #   ###     # # ## #         #   #####  #   
  #       # ###   ###   # #  # #  ##            #   #  #    ##  #  
#   ##  # # #     ### ##         #      # ##  #       #  #   # #   
##   # ##      # #    ## ##   # ## #    #   #     ##  #    #  ###  
  #     #  #         #     #   ##      #   ##   # # #         #    
  #  ## #   ##    #      ##  # #  #  # #       # # ##  #    #   #  
  #    #          #         #      #    #  #  #    #  #  #  # # # #
    # #  ##  #   #  #  #     # ##       #  # #     #    # ##    ## 
#####   #      #   # #    #   #  #  #    ###  #     #            # 
  ##   # #   #   #    #    #   ##     ##    #       #  ## #   #    
#       #  ###   # ##          # # ###              #  #  #   #  # 
##         ##   ##  ###  #    #  #    #   #     # #   #   ## # #  #
 #  #     # ##       ####  #       # #   #     #   #   # ###       
  #    ##  ##  # #  #  # #   ##     #    #  ##    ## ##   #  #    #
   #   # # #  #      #     # #    #        # #    # #   # ##    #  
 #   ##      ## ##         # # # #      # #     ####  #  #     #  #
        #     ##     ###   ### # ### # #   #     ##     ##  #      
    ## ## # #      ##   ##  ##   #        #       #    #   #      #
 ### #  #  ##      #  #   # ##   #  ## #   #   ###        ##       
       #  ##   #   ###    #    # #   #  #   #         #   #  ##    
     #     ###   #        #    ##     #       # # # #  #  ## ##   #
# #    # ##          # #  ## # #  #      #     #### # #     ##     
##  #  ##   # #   #  ##     # #            #    # ###       # #  # 
 ## #   ## ##    #   #   # ##       #  #   #     #      #  #  #    
#    ##   #    #     #  ##  #   #    ##  # ## ##  ##  #    ####    
       #    ##  #   #      ##  # #   #      # # ##    ###  ## # #  
   ##  #       #  #     ## ##     # # #   #  ## #       #        # 
  #  ## #   # #    ##    ## # ##    ###  #  #     # #    # #   ##  
# ##  #   ##   # ##       #      # # #     # ##  # #   #       ##  
           # ####    #  #  #    # #      # #     #  # #      #     
## ## ##  #    #   #  #  ##    # #  ## ##  ##                      
 # ##  ##      #    #        #   ##     #  ## #     #    #         
   # ###   #  #  #       ##     ## ##    #        ## # #   #   #   
# #    #     ## #   ##       #            #   #    # #   #     #   
   ##    # #  #     ## # ### ##### ##    # #       ##  #      # ## 
   # ### #        #    #   #        #   ## # # #    #  ####       #
### #                   #    ##    #    ##    #   #         #   ## 
  #   #  # ##   #      #  ##       #      #   #  ## ##       #    #
 #    ##   ##           # #          # #     # #        #  ###    #
   #   #  #  ##    ###    # # # # #   #  ##     #  #  #    #     # 
 ##  ## #    #  #     ##       #   #  ###  #    # # # ###    #     
#  # #   #     ##           # #           # # ##   # ##    # # #   
   #      #  ## ##    #  # #   #  # #  #   ####  ###      #       #
            #    ###   ######         #   #   #  #      #  # ##  ##
     ## # #   ## #  ####    ## ###         ##  #    #   ##      ## 
### #  #                #    ###  #   #    # ##  # # #   #  #     #
  #  #       ##    #  #  #     # #        #      ##     #  ##    # 
   #             #    #     ### #  #      #  ##   # #  #  #  #     
   #      # #       # #  #  #  #    # #    #    #         #       #
    #  #  #   #          ####       # ##     #  # #      ## ##     
    ## #           # #  #     #    # ##  #         # ####   #     #
##  # #       ##  #    ###                #   #         # #   ### #
 ##     #  #   #  #  #   ##  #   #  #        #   # # ## ## #       
       ##            ### #   ## # #  ##  #    #     #       ### # #
#        # ##  #        #  ####  ## # #  # #  # ###      #     ## #
  ###            #  # ##  #    #     #  # ##  #   #    ##    ##   #
      #      # #   # # #  ##  #     #  #  ###         ##   ##  ##  
 #        ##       #        ## # # ##   #     #  ## ####    # #    
# ### #  #     #             ## ## ##   ### ##      #       #  # # 
 #   #  # #  # # #   # #     # #      #        #           ##   #  
   ##  # ##     ###### #    #   # # #    # #  ###   #   #    #   # 
   # ##   # #  #      #             #     #                  # ## #
    # # ## #   #  ###   #    #    #              # #            ## 
# ###     #  # #   #    # ##   # ##       ##  # # #  # #      #####
 # #              # ###  #   #       #  #  #    #  # # # #  #      
 ##  # #   ## ##  ##    # # #  # ## #    # #   ### #  #        ##  
## ##   ## ##  ## #  #  #   # ## ##      #  # #    ##  #  ##   ##  
  #     #  # #    #    ##   #  ### #           #        #    ### # 
     ##E     #    ###   ##  ##   ## ## # ##    #        #  # #   # 
# ##  #   #  ## #   # ##### ##     #   ##   #       #      ####   #
## #     #  ##    #   # #  # # #  # #   ### ##  # #  # #         # 
              #               #    ##   ##    #         #          
 # ##        ##  #   #     # #  ##  #  ###   #    ## ## #     # #  
 #  # # #  #     #  ###     # #   #           # #    #           ##
    ## #  # #       ##   #       ##      #        ##   #     # #  #
  #    ##  ##   #  ##  ###  #        ## ##    #     #  # # #     # 
 # ##  #    #    ##        #  ## #      ##  # #  #     #  ##  # ## 
##  #  #    #    ###  # #      ## ##   #      ##   ## #           #
    #          ##   #     #       # # #   # #          #   # # #  #
 #    ##  ## ####   #  ### #     #        ##   ## ## #        #    
  ## #    ## # ## # # #       #    # #       #   ## ##  #       # #
 ##  # #  # # ##  ##   # # ##   ##      #   #   # #    #  ##   # # 
#   #  # # #       ##        #     # #   #  #  #  # #  #  #      ##
  # #  # #     #  #            #      #     #  ##   #  #  #        
# #  ###   ##    ###   # # # ##  # #   # #   ##     ## #  #    ### 
#     #    ## #  # ##  ##      #      ##     #    #    #   # # # # 
    #         #     # #  #   ###### ##  # #### # ##     # #  # # # 
#  ## ## ### ###  ## #    ##      ##          ####      #   ##   # 
#    ## #          #         #     #      #   #          ###    ###
 #  #       #    #   ## ###     #       ##    #   # #     ##    # #
 ##   ##### # #   #    # #   #   #           #  ##         #    ## 
  ##         #####          ## #    # #  #    #       # ##     # # 
    # ##   #    # ##  #  ##  #       #  #  # ##  # #  #    ## ###  
       ##    #   #    ##        #   #    #   # #         ## # ##   
     ## ##  ## #  # #  #    ##     #    # # # #        #         # 
  #    #  ##  # ## # ###     ## #       # #     #  #  #######   # #
