             # #     # 
#S#  #    #            
   #  # #    #         
#   #      #           
#    #   #        #  ##
            # #  ##  ##
   # #   ###  # ###    
      #     #   #     
      #        ## ###  
   #     # #    #  #  #
                  #  # 
#  #  ##       #    # 
 ## #   ##  #   ## ####
 ## ##   # #  ## #     
  #     #####      #   
    ### ### ###  #  # #
 #   #   #      #   # #
     #     #       # ##
#  #      # #    #     
  # #      #      #  yh
      # #        #     
    #  #    #  ##  ##  
##        # #   #   #  
         # #    #  # # 
     # ##    ###   #   
## #    #    #     ### 
 ##  E     ## # ##     
  ###    ##    ##  #  #
    #  ##    ##      # 
 # ###  # ##   #       
  #   #  #     #  ### #
   ###  #    ## # #    
 ## # #  # #   # #  # #
#      ## #     #  ####p
  #  ##    # #      # 
 #      #         ### 
  ####    ##  #     # #
         #   # #  #  ##
 ##     #     #       #
 ## #   ##   # # # #   
#      #      ##   # ##
 #   #     #    #      
  ##  ###   # ###  # # 
# #  # ## #   ##  #####
  ##      # #  #      #
   ## #      ##   # ## 
  #        ##       ##
 #    # #   #     #  # 
