    #       # #     # ##      # # ##     #  #  #       #### # #     #   #   
 S # #      #                  # #    ##    # ##        # # # # # #        #
#      #   #        ## ### #  ##  # # # #                      #    ##### # 
    #      #    #     #         #      # # # #  #    #      #       #       
#   #  # #            ## #    #   #  # #     # #    ##   # # #  # #      # #
##  # # #                   ##  #        #     #    # ##    #  # ###    #  #
#     # ###      #   # #  #    # ##       #     #    # # ## #      #  ##    
  ## ###  #    #  # # # #  #   ##   #    #        #     ### #       #      #
   # #  # #  #  #         # #  # ##  #   # ##       #    ## # # ## #  #  #  
   #        # ####      #  ## ##   #  ##        #  #  #   ##  # #    ##  # #
#   #        ##  #    ###   ## # ## #  #             ####             ### ##y
#   #  ### # ###    ## ##      ##   #  #    #   ##   # # # # ###   #  # #   
  # #    #   ##  ##      #         ####  ##  ### #      #  ##   #    #     #
     ## ###    # # #    #    #       ## ##  #  #   #     # # ##       ##  ##
  ##  # #  #  ##  ##       #        # #  # #            #   # ####      #   
  #   ##   #    #   # ##   ##     ##   # ## # ## ##  # ##    #    #     # # 
       ##   # ###  #       #         ### # #   # ### #  #      #         #  
 ###   #  ###    #   #    #       # #     ##       #       ##     # #      #
#      #### #    ##    #   # # ##  ##   #   #          ### ##  #  #    ##  #
# ####       #     ##   #  ## ##    ## # #  #      #  #   #    ##### ###  # 
       ##    #  #  ###   ## # #  #  ####  #   #    # # ## # #  # ###   ##   
 #  #       # #  #  # #  # # # #     #  # ##    # #   #  #   #    ### # #   
 #      #     # ## #     #   #    #    #   #    # # ##        #  #    # # # 
          #  #       #   #  #  #   #  #      # # #  ## # ##  #       #    ##
#              # # ### #     #  ###  ###     #### #         # ###   ## #    
  ###     #      ##  #          #       # # #  # #   #  ###   ##   ##   #   
   #  #      #       # #   #   ##       # #     ###     # ##   ##     ##    
#  # ### #   ##   #    #                    #    #     ##     #   ##     #  
 ##    # #  #  #      ##      ##  #     ##  #     ### #      # ##     # ##  
       #  # ###  #    ### # #    ### # ## #       #    #          ##  # #   
   # #       #   # ### ## ##  # # #    #  #  # ##                  #     # #y
## # #      #  #   #   ##   # # #  #  #  #       #    # ##  #   # ##        
 # ## # ##   #     #  # ## #         ##  ## ## # #    ###  #  #### #   #   #
#          #     #     ##    #            ###  #  # #  #  #     ##  # #   # 
 # #    # ##   #  #     # ###         #    # #             #   #  #  ##     
#  #  # # ##     #      ###    #    ## # #    #       # # #  #  # # ##   ###
 ###   #      ##    ## ##   ###    #   #  #      ##   #  # ##   #  # ## #   
##  # # #   # #  #    ## #     ##      #   #  #   #   #      ###    #     #
      #       #      #     #  ## #  ## ##  ###   # #   ## # # ## # # #      
###  #  #    ## ##i  #  #    #  ###  # ##  #  ###  ##    ##  #  #      # #   
       #  # #        ##       ###      ###        # #    ### # # ##         
# #    ## # #   # #### ##    #   # # ## ##      # # # #      ## ##  #     ##
   ##      ## #    # ####      ###   ###   #      ## ##    #       # #  #   
    # # # #  #        #  ##    ##  #       #  ## #        #  ## #   ##  # # 
         #### #       ###     #       #     #  # # #  # #    ##   #    #    
#  # #  # ##    ### #   # #     # #  #   #      # #       #  #           # #
## # #  # ##  #       #    # # #  # #  #  #   # #    # ##  #  ###  # #    ##
      # #    # #          ##     #    #     # E       #   # ## ## ###  #  ##
   #  # #  #    # #       ### #  # ##    ##   #  ##   #       # #     # # ##
       #    #### #     # ##               ##     # #  #  # # # # #### ##  #
    ##         #  #  ### #    #   #    #   ###    #     # #              ## 
     ## ####        #  #           #  # #    #      #       #       ##  #  #
##     ##  # #   #       ###  ##          #     #  #  ##     ##    # # #   #
#  #  #  #   #  #      # # #  # # #   # #    ##      #         # # ##  #  # 
   #  #  #  #        #  #   ##      #  ##       #  #       ##  #    #  #  # 
        #   #      ##       #  #         #   ######     #     #   #    #    
#      #      #     #     #   #           #    ##    # ##      ##      #    
 # # #       #     ##  #    #  ###        ##  #### ###  #  #  #     # ##   #
 # # ##    # #   ###  ##  #   ## #  # #     ##  #   # #       #    #   ##  #
 #   #  #     # #    #   # # #    E#      # # ####  #    # #  ###     # # # 
  #  #   # # # # #   #  #              ##  #   #   #  ### # ## #    ##      
 #     ##     ##      #          #      # #  #   #   #      #  #  ### ### # 
  ##   #  #       S ## #  #### #  ##  # ##       #  # #   #   #         #   
  #   ##### # ##  #    ###   #  ##  ##  #  #        #          ##  ##    #  
#    ###  #     #  #  #   ### #  # #       # #  ##    #     ###   ##    ##  
  #   # #   # #     ###        #    #   ##  ##  #  #    #  #    # #    #   
          # #        # # #   # ### #   ##  ##  # # ##  #   ## #  # ##     # 
# ##    # # # # #  ## #  ###    #    # #    #  # #       #  ##   ##  #   #  
##    ##     #   # #    #     #  # #     #  ## ### #  ##      # ##   ####   
 ##   #      ##### #   #### E    #     #  #       ##      #              ###
     #   #    #        # #    ##  ###  #  ##   ###  #      ###  ## # ##  ###
         #     #                 #    # #   # #  ## ### # # #             ##
   #     #        #       ##     ##     #  ##  #   #     ####  #  #   #  #  
     #  #      ##  ##     #  #   #              ##      ###     # ## ## ##  
###            #   ## #        #             # #      S    #   ###          
 ### ##    #  #    #        #  ##   #i# ##    #  #  #   ## #   ##### # #     
          #p    #    #   #    #          #    #  # #   #    #  # #  ###      
