#   #      #           #      #
 S  #      #  #### #      ##  #
#     #  ####       # ##   #   
 ###    ##   #   ## ##      #  
 ### # #  ### #  #    #    # # 
# # # #### #  #                
  #  #  #      ## #  #    ##  #
    #  #  #     #     ###  #   
  ##   #   ##### #  ###     ## 
    #  ##   #      #   #  # #  
 # ##     ## #  # ##### # # # #
 # #  ## ###       #      #    
#  #        #  #  # ###    ##  
##      #            #     ####
### ## ## #   # #           ##
# ##      # ##   # ##   # ### #
#   #     ## #  #  #  # #     #
# #  ## #  ##  #     # #  ## ##
   #           ##   ##     # ##
 #####               #   #  ## 
          #   #     #   #  #   
    ##           ## #  #    ## 
 #   ##    #   #     #    # # #
   # # #    # #   #     # #    
##   #                 ##      
 #    #       ###   #   #   ###
# ###    #  ### ## # # #    # #
  #    #    #  #  ##   #      #
 #     #          ## #   #     
#  ## ##   ###   ###### #      
     #  #     # #   #  #   #   
    # ###   #  #              #
  #        # #  ##    ##   #   
 ##  # # #     ##  #      ## # 
#  # # # ### #### #  #    # ## 
  #      #   #   # #  ##    #  
#   #     ##    #         ### #
  # ##  ###    ## # # #####    
####   ##  #     #  #  o        
##        ####  # # #    ##  # 
#       ###  #  # #  # # #   # 
  #  ## ##    ## #  # #     #
###      ####  # # #          #
    #         # # #    ##      
 #           #  # ##      # #  
#   #          # # #  # ## ##  
# #  ##     #     ##    ##    #
      ## # ##  ##     ####     
  ###    ##  #             ##  
        ## #   #    #### #  # #
  ### # #        ## #  #       
 # #   # #    #  #   ## ##  #  
   # ## #  ##    ####  # ##  # 
           #  #  ##   # ### #  
       #     #   #  #   ## # ##
  #            #           #   
 #   #     ##  ## ####   # ##  
#  # #     ##              ## #
#   ##     #    #    #     # # 
    # ###  #    #  # #   #     
  #  ###     # # #  #     ##  #
 ##  #   # # #  #  #    # p     
### #  #      #    #  ##  # #  
#    #  # # #     #     #  #   
#    ### ####  # #  #   #  #   
# #          ##     #   # #    
  ##   # ##  #         # #  ## 
  #    #       #          #    
   #    ## ##    #   ### #    #
#  #   #    #### #      ##     
  ##  ##          #    #   #   
    # #   #          #      ## 
      # #   ##    ##         # 
    ##  ## ### #       #     # 
#      #     #  #  ##      ## #
    ##    #  #  ##   #      #  
 #          ## ## # ##  #   #  
 # #  #    #     #  ## # ##  # 
 #  # #  ##  # #   ### #####   
  ##     # #  ##   #    #  ### 
  # # #          #    #    ## #
# ##     ##  # #        #  ## #
   #   # #      #    #  # ## ##
   #    #  #      #  #   # ## #
 # #  ##  # #  # # #   #  ###  
  ## ##    ##       # ## #  ###
    ##  # #     # ##   #   # # 
#         #          # ## #   #
       #  # # ##     #  #  #   
         ## # #   #     #     #
 #  ##    #   ##    # # ## ##  
#  #   ##   #  #       # # ####
#        #          ##   #     
# # #   ##  #             #    
      #                 #      
      #   #          #  ##  ###
###   # #     ##   #   #     # 
 ##    #    #  #   #           
  ### ##     #  #    #       # 
  ##        #      # # ## #  # 
# #             #   # #  #  ## 
    #   # #        #      #    
 #      #  # ## #       #      
#      #  #    #       ###    #
   ##   #   ###     #   #   # #
##  #   #   #   #     # ##  # #
    #  #    #  #        #   # #
    # ##   ## #     # ##  ##  #
## #     ###  ### ### ##  ## # 
###  #       ##        #    #  
### #     #       ##    ##     
#    ###  #  ## #  ##   #    # 
#       ##      ## ##    ##### 
#  # #   # #     #  #   #   #  
  #           #### ##    # #   
     #      ##     # ####  # # 
                 ##    ##  ##  
#    #   ## ###      # #     # 
 #  # #     ###  #  #       ## 
     E  #    #  ### # ###    # 
##   #       #    ## ## #   # #
 #   # ### # ### # ## ##       
 # ##        #     ##  #  #### 
#  ##    ## # #   #  # #  #   #
###     #        #    #      # 
#  #  #     ##   ##   #        
#      ## ###  #    ##    #  # 
   ##   #    #        ##       
    #    #  #   #   #      #   
   #    #    #  #    # # # #   
#     #   #  #   # #     # #   
           ###           ## #  
  ## #  ##       ##      #  #  
 # # #    #     #  # #    ## # 
  ##   ##         #  #       # 
   ##         # #  ##  # # ## #
    #    # #       # # #   #   
   #  #  #   # #  #    ##   #  
  #  ## #  ##   ## #    ##     
 #   ###          # #      ##  
  #  #  ### #   #   ## ##    # 
     #   #        #     # #    
 #  # #  ###        # #        
    #     ##  #  #       #    #
 #     ###  ##  #    #  ####   
#    #   ##  #  #       # #  # 
###      #  # ##    #     # ## 
#    #         #    ##  #    # 
    ## #   #    #  #        #  
   ##    # # # ###  #    # ##  
  #     # #    ##       # #  # 
   #    #  ##  ### # ###       
    ##     #    # #  #     ##  
 # #  ## #     ##     # #    # 
 #   # #  ##      # #         #
# # #  # #  # ## ##          ##
#   #      # ##    #   # ##    
### #   # #      ###  ##      #
  #   ##  #      # ##     # # #
   # ## # # #   #         ### #
    #   #       #    # # #  ## 
###    # #           # #    #  
#        ##   #      ###       
