   #     #         # #    #   #     # # # ###   ##    #  ## ##  #  #   ##        #     #    ##### ## #        #   #   #  # #    ####      
 S   ## #  ####       ##     #    ##         #  #  ##   #    ##  ##      #    #  #  #  # ###  #   # #      #   #       #    ##    ##   # #
         ##   ### # #       ##  # # ## ##  #     #   #  #    ###   #  # ##     # #    ##   # #     #   # # # ##      ##  # #  #    ###    
 ## ##    #  ## # # ##      #     ##  #  #    # #    # ######### #   # ##  ##          ## #     #   ## ### #      # #  #       #  #    #  
   #  #  #   #     # #      # ####   #  #   #   ####    # # #   #   # #   #    #      #      ## # #   # ##  #      ##   # #    #    ## ###
    #   #   ##    ##   # #  ##       ## ##      # #  ## #      # #   # #   # #   #         # #  ##   #  # # #      #  ###   #  #   #    # 
    #  #    #    # ###      ### #   #  ## ## ## #  # # #      # ## #    #     # ##  # # ## #    # # #  # # #     #   #     #   #      ##  
 #    #     #####   #                # #     # #    ##   ## #   ##    #    #         #   #  ###      # #  ##  #   #     # ##    #         
  ## #         #  #### #    # ###       ##        #     ###   #  #  #  ###        #     ##### ## # # ##  #          ### # #     #   # #   
     # #   #      #  #          ##   #    #   #   # # ##     ###          ## #  ##      #  #    #   # # # #  ##         #      #     # # #
  ###    #  ###  #            #   #  ##          ####     #####  #     #     #   #       #   #     #   #     ## ##  #   # ##   # #        
         # # ###  ## #   # #    ##  #   ## #     ## #### #  ##   ##   #    ###                ##  # ###   #   #  # #  ##          # #     
###    ##       # ## # #         ##   #          #  #     #  ###   ###    # # # ##  #   #    #  ##  # ## ##  #   #  ##            #   ### 
    ## #  # #    # ###    ##### ## #  # #  #     ###      ######        # #  ###      #     ## ## #      # #    ## # # #     ##      ## # 
# # #     ####  #       # #   #### #   #   # #  # # #   ## #  #  ## #  #   #    # ##### #####       #  #    #      #   # # #   #    ##  # 
  ##      #   #   #   # #    #    #   # #        #  ### #   ### #  #   # #   #  #      #   ###  ##            #   # # ### #  #### ### #  #
#    #   ###      #   # #   #    #   # ##   #   # ## #       #                #       #  # #     #  #     #   # ##   # #  # ##   #  #     
   # #  #        # ## #   #    ##  ## # # ###   ##    #     ## #  # # #      ## ##  ##      ##  #  # #   ####    #       ## #  # #   #    
 #  # ##            ##  #        #  ### #  #    ###     #      #            #    #  # ##   #  ### ##  #   #     ##   ### #        #       
 #     #      # # # ##  #    #  #       #     ## #      # #    ##   #    ##    #       ###   #      #    #   ###       #       #  # ##    
# #   ####  # ##   #    # #   # ##  #   ##  #        # # ##### #  ##  # # # #   #  #   ##  # #         ###      ##     # ###    #     # # 
#  ##  #      ### # # ## ## #           # # #  # ###            #  ###  #          # # #            ####     #  ###   # # #   #      ##   
    #  # # #    # #  #  #    #    # #         #   ###  #     #      #   #  #   # ## ## # #        #    # #     #      ##  #        # #    
  #   #  #    #         #  #   #       # ##   #        #      ## ####      #    #   #  # # ##  ## ##           ##  #    #   #       ##   #
#    #  #  #       ##    ## #  ######   ##   ###  #    #   #    #   ### # # # #   #  ##   #     #             ##      ##      # ## #   #  
 # # ##   #     ##   #               #          ##    ##  #  # # ## ##  #     #        ###         #  # ##   ## #                 ### #   
  #  #    # #      ##  #     #     ## #  #   # ###       #     ##     ###  ##   #     #       # # #      ####   #    # #  #  ###     # #  
    # #    #    # ####        # #  #  #  # #  #    ##  ## ##   ## ##  ## #         ###           ##   #            #     #   # ###        
 # # ##   ## #  ###  #       ### #   ###     #  ## # # #          #   #   #     #          # #  #  #     ### #              #  ## #  #    
  #   ##  ###    #           ###    #      ##    ## ####  ## #   # #       #    ####            # ##    ##   #  #  ##### # ##       #   # 
 #  #    #      #  #    ### #   # # ##  ##  ##   #       #  # # ###      #    #        # #  ###  #     #    ##        #  # # #   #     #  
#    #  # # ####### #  #   ##   # ##  #    #  #  #  #    # #     # #     ## # #    # # ### #   #   # #    #   # #     #   #  #  # #   ## #
# #   ### #     # ##  #  #  #  #  #  #        #  #   # #   ### #     ## #    #      # #   #  ##  ## #  #  ##   ## #   # ##       # #  #  #
  ##  #       # # #    #  #     #    #            #     #          # #     ###        ##  ##   ##       #    #  #  #  #  ###       #     #
 #  ##    ##    # #      #   ## #  #        ##   #####      ####   ## #   ## #         # #####      #  ##  # ####     #     ##   # #      
   #    ##      #  # # # ##      # #      #     ##### #  # #   # ##   ####   # #  #   #  ##       ##          # # #   #             # ####
  #  #  ##   #######      # #   #     ## # #    #  #   # # # ##  #       ## ## #   # ###          #  # #  #    ##   ##  #        #   #   #
    #   #  ###     # # #  #  # #     #   ## #    # # # ##    # #  ##     # #    #     # #          #      #      #     #       ##    ## # 
      # ## # # ##### # #    # # ##    ##     # # ## #    # #  # ## #  #   #  #  # #     #   ##   #   ##    # #  ##  ###       #  # #     #
 #  ## # ##  #  ## ##        #   ##   ### ## ## # # # # #      #  # #       ####       #     ##    #  #       # ##    ##    #   # #   ####
 ## ### ## #           ## # ###    ##     # ##  ## #                #        # ###      #      #    ##    # #    ##  #   # ###   #       #
                ##        #      #     ##        #        ##     #     #          ## # #    #   #        #           #     ##   ##        
     #   #  #        # # #  ## # #         #     ##   ##   ##    ##   ##         #         #     # # # # ### #  #      #   # # # ##    #  
       #  ##            #             #   ##    #   ##  #   #   #######           # #      #    ###             ##  ##   #         #    # 
                ###  # #    #     #    #    # ### #      #   ###    # #            #  # #  ## ##    # #     #    #  # ## #   #####        
## #    #    #    #  #    #  ###       #  #         # # ##   ## ## #    # #   #        ##   #  ## # #   #   ##      #      # #          # 
   #       #     # #  # ## #      #  # # ###        #  #         #         # ##  #    #  #      #   #  ###   #   ##          #       ### #
       #  # # # #   #  #      ######  # # ### #      #      #  #       #         ##  #   #             #  # #     ####### # ###     #     
    #            ###    #   # # #    #  # # # ##  ### # #  ##  ###   # # #   #  ##  #        #   ##     #####       #  ##       #  #    # 
#     #  # #   ###  ##   #     ##   #  ## #   ##  #    ###     #  # #   #### #  # ###     ## #     #        #  #         #  # ##     #  # 
## #      # # #      ### #    # ##     #   # ##      ## #  #  #         # ### # ##   ##  #   #             # #   #       #  #            #
   ### #    ## ## #    #   #### #      #          #    #     #  #    #                            #  ###  # #           #     ##   ##     
#  ## #     ## #     ## ##   # ##          ##        #   # #       #        ##  #  ##  ##             ###       ##   #   # ###   #    ##  
 # #   ##          #   #  ## #   #     #  ## # # ##  #    # ##      ##  ##   ##          #####      #    #   #   #   #  #   # #     #  # #
      # # # # # #   # #    #  #  #        #          #     ##    #      # #  #  ####         ##    #                  #                 # 
# #  #  #   # ### #  #  # ##      #    # #   #          # #  ########  ##  ### ##     # #      #          #   ##   ##  #  ##  #      # ###
#  ####     #         #   #    ## # #        #    #   #    #   # #    #       #     ### ##  #  ##  #  ##  # #        ##  ##       #  #### 
 #### #  ###     #  # # #  #         # ##    #    # # # # #       ###    #         #       #    ##   # #   ##  ## # ## #  #         # # ##
 # # ## # #     #   ##   ##    #####  # #         #   # # #     ##           #  #       #       # # #              #    ##   #    #       
  #  #             ##  # # # # #  # ## #  # #   ### ##  ####    #    # ###  #       ##             #        ###   ###   ##       #   # #  
      #   #   # #   #     # #    #     ## ###  #  #      #           ##  #    ### #       #      #### ###  ##  #  #    #    #       #   # 
          #  #    #  # # #  ##  #  #  # # # ##   ##         ### # #      #    #  ###     #         ###     ##   # #        # ##    #      
     # #        #   ## ###   #    #  # #             #  #  #    #   #    #   # #  # # ##     #                            #         #   ##
              # # #  # #### #    # ##   # #   #    #    #    ## ##    ##  ##             #      # #     #      # #  #    # #    #   ###  #
###   #  ##  #      #  ##      #   #     #   #  #  #    #     ##      #  # # #       ##   #   #       #    ####        ##   ###     ####  
    #   #     ###   #  #  # ###    #    #   # ##     # ##    ###    # #  #         # ## ####       #  ##   #         ##  ###     #  #     
    ###   #   #   # # #    #  #   ##     # ###  ##    #  # #   #  ## #          # #     # #   ##    ##    ##    ##  #        #      ##    
#  #     #   # #     #    #    ##     # #  # ## ##  #     ## ##   # # ##    #     #  #  # #  #    # #   ##       # #   ###        #      #
#    ## # # # ##  #  # ##  #  ##        #  #   ## #   ####    ##    ##    #  ##      ## ## ##    #  ## #  #  #            ##    ###       
 #   #  #             ## ## #     #   # ##  ##  #           #  # #        #         #    ## #    ## # #  ##   #### #  ## # #  #   ##  #   
    # #    #     # ## #     # ##      ## # #  # ##  #   #      #   #  #    #         #  #    ## ## ###      ##  #   # ##      #     #     
   #    ###     #  # # #  # #  # #  #      ## ###   #      #    #         #  #       # # #  #  #   ##  #  ##     ## # # ##      #   #   # 
    #     #  ##    ## #  #  #   #  ## #       # # # ###     #        ##  #     ####        #  #        ###     #  #             ###   #  #
# #  # #    #    ### #     #      #    #     ##  ###  #    ### ##    # #    # #        ##    #       # #   #### #     #    #     # ##   # 
   ##   ###    #       #  ##  #  #          # #     #     # #     #     #   # ## # #     #          #    # # # ## #    # ##  #  # ##  ####
   # # #      #          #  # ##  #        ### #          ##  #   #  #     #       # # #    ##  #  #  # #  #   # #      #  ## #   ##     #
    # #          #   #     #   #    # #  #  ##    ##             ##     ##     #  #   #   #  ##  #     #     # # ##  # #  #  #####   #   #
 #    #  #          #    #    # #          # #    ### #  # #    ###   ##    ###  #    ## #       # # #     ### ###  ## #  #  ######    ## 
 ##  #  ##  #  # #            # #  ###   #  #  ##  #  # #    #  ##    ###  #   #  #####   #  #         #  #   #             ##            
 ####    ##    ##    ##   #  #          #   ## ##     #      # #      #  #    #  #        # # #  #   ## # #  # # #       #    ######    ##
       ##  # #   ###    #    #      #   ## # ##    #   #       #  #   # ## ##  # # #   #          #    ##        # #      ## # # # ##     
 #     #     #  ##  ##    # # #       #   ## #    #       # #       # # #    # ##  ##   # #          #  #  #  ##   #           ####       
#      ##      #   #  #  ##  #      #     # ####    ##     #  #  ### #  # ##    #  ##  ###    #       ## #   ##    #    #      #     ###  
 ##### ##        # #      # #  #   #   #                 # #   #     ###   ##      #     #         ## ###        ## ##        ###    ##   
 #  #  ##  #      #  ### #  #   #       ##### #  #   ##    #### #  #  #        ## #   #  #        #   #  #   #   #     ##   ###  # # #   #
#  #    ###        ##    #  ## #   #  ##   #    ##  ##  ##    # #  # ##  # # ## ##  ## ## #    ## ##    #         #  ## ##     # ##  #    
# # # #  ##  #   #                    # ##       ##   #     #      # #   #  #   #        #  #  #  #  #   #  #   #   # # #  ## #  #        
 #  ##          # #    ##  #   #### ## ###    #     #  #      #  #      # #  # #   ####  #     # #       # #      # # ##  #         #    #
          # #     # ###     #   #        ###  # #     ####   # # #  #     #     ### # # # #  #     #    #     #  #  #  ##      #  # #     
     #    # #      # ## #    #  # #     ## ### #    ##  #       #  #    #   # ### #            ## #         ###   # ######  ###           
 # # ###          # # ####    #    #  #    #             # #    #     #  ##     #          ##        # # #      # #     ## ##  # #  # #   
# # ##  #        #  ###   # #  ###   #   #  #  # # ##      ##      ##         #   ## #   #  # #     #    #         ## #  # ##    #     #  
    #  #  ##    #        #      #    #    ##  #### #  # #   ###  ###  #      #  #     #   ### ##  ##  #   ##    #     #   #     #    ##   
     # ## # #   ##  # ## # # #  ###   # # #  #   ###  # ##    #  ##### ##   ########     ###        ##    ## #   #     # #   # # # #   #  
 #  # ##     # # #   #   #   # #       #  #       # ##  # ### #       ##  #     ## #        ##    #     #       #     ## #     # #      # 
  # # ##     # # ### #  #  ##  ###       ##          # #    #          #   # #    # ####         # ## ###  # # ### # ###    ## ##   # #   
  ####      ##   # #    # #    #  # #  #  #  ###  ##    #  #   # ### # #  #   #      ##  #             # #     #    ##     #   # ####     
# #   #  #   ##  #  #   ##   # #           #   ##       # #    ## ##           ##     #      # #   # ## ##   #       #     #### ##    ##  
 #  #  ## #   ### #  #####  #                #  ##                #        ##   #   # #  #    # # #   #### ## #  #  #   #   #       #   ##
   #     ### #  # #  ##  #        #         #    #   #    ##    #   # # # #  #   #    ##    ## #   #     # ##           #   # #           
   # # # ##  ## ###   #          #      # ###     ### ##    # # ## ### # #           #    # ##     # # # ###  # #     #  #      #   #  #  
#   #             # ##    #   # ###             #       #      # ##  #   #     # ##  # #   # ## ## #     # #         # ## #     #  ###    
# #     ###     #   #      #          ## ##  #     ##   # # #                 #     ## #  #   #   #          # ##     #   # ### ####   # #
 # #####  ##  #     #            ####    # # #     #  # # #     #     ###        # # ###       ##    ###    #   #   # #    ###  #     #  #
    ##   # #                  #    #    #     ####      ###      #  ###   ## #  #  #      #            ##     #  #    #     #    #      # 
## #        #         # #  # #     #  # ##   ##          #     ###     #  ##    # # ## #    #   ##  ###  #  #  #  #   #  ##     #   ##  # 
     #    # # ##   #  #     #  #    # ### #   #    ## # #         ##   #  #    #       #   #  ##  #     #  #    #        ###     # ##     
    ## ##    ### # # # # #  #  #      # ##     # # ######     #      # # #        #           #      #  ##      #     #####  #     #      
 ## #     ## ###    #   ## #      # ## #  #      #      ### #  #####               #  #    #  #       # ##       # #  #      ##        ###
 #    #  ##        #### #   #   #      #      #      #   ###      #     ## #        #    ##  ###     ## #   #  ##  #                    # 
# ### #  #   # ##  #      #          #        # #  ##      #  # #######   #              ####       #  # #  # #       #   #     #    #   #
    #  ##             # # #  #         #  #    #     #    #  #  #    #### # #  #   # ##  #    #   #  # #  ##   #  #   # #    ## # #   ##  
#  #   ##    #   # #  ##   ##    #      #  #      #       ##     # #    ##    ###   #  #     #      ## ## #    #   #  ### ## #  ##     #  
    #  #      #       # ###            # ##      # ## # #   # #  ##  ##   #  #   #       ##    #                  ##    # ##   ##  ##  # #
# #   ## # #   #      ## ##     #  #    #    # ##   #  #  ##    #### ##   #  #      #     ####    # ## ##  #            ###      ##   #   
       # # ###     #      ##   #     ##  ##  #   #   # # ## #   ####  # # #   #       # ### # ## #        ## #  #  ##         ## # ##    #
      # #  #      # #  #    #   #        # #          #  #    ### #          # #  #         # # #     ## #   # #   #   #  #        # #    
 #     # ##   #       ###  ####           #   #  ###     #   ##      ##       ##    #    #    #  #      #  # ## ##     ##  #    #   #     
#       #  # #    #### # #   #  ##   #              # #    # #       #     #      #  #  # # #    ###   ##       #    #     #         #  # 
# ##  #   ##  ##        #  ##     ##    ### #   #   ##          #  ##   #   #        # #        #  ## #     # #      ##    # #  ##     #  
     #   #   #       #         ####    #      #       #  # #       #    ##   ## ###  # # # ##     #     # # #   #  #   ## #        # ## ##
 #   ##     #    #    #       #  # #####        ## # # #     #       ##  #     ## #     ##     ##   #   ## #        #   #   #     #       
    ##     # #  #   #         #        #   #  ##       #      ##    ##  ##  #   #       #           ##       # ## #          #         #  
## # # # #     # #  # # ##  #     ## #       # #    # # ### # ###  #     #     #        ## # ## # #    #         ##  #           ##     ##
#### ##  ##         # ## ##  ###    ## #    #  #         ##    ##  #  # # # #   ##       #  # #  #  #  #  ##     ###     #  #      #####  
  #     # ### ###   ##   #  ##            ##  # #    #    ##    ###   #   # # ## #  ##  #              #   # ###  ####      #  # #       #
 # #   # #   #   #   ###     # ###        ##     # #  # #   # # #  ## #     #           ##  #  #           #  ##       # ####  # #      # 
 #           # #         ##    #                 ## # #   ##       ###       #           #    # # #   #  ##     ###  # ###    #    #  #  #
  #  ##   #  ### #  ##  # #   # #    ##    ###   #  # ##     # #  #   #  ### # #  #             ## ##        ##      #  #         ##   #  
## ##   ##  ##   #    ## #   ##    # #   ##  # # #  #       #             ##  # #  ##      #     ## # # #      #    # ##     #  # ##     #
  #            #    #   #    #    ##    #      #   # # #    ### ##   #  #     #   #      #  #  #     #    #  ##     ###   ## #  # ##  # # 
    # #     #    # #    ##  ##     #      ##  #       ###               #      #    # # #  #       #  ###      ## # ##   #   #    # ##   #
  # ## #     #  #   #  # ##   ##  ##  #  # ## ### #    #     #   #      #   #  #       # #            #   # #  #     ### #   #         #  
 #              #        ##   # #  #   ##  ##  #   #     # #        ##  #   ##    # ##  ##  #  #    #      ##     ##    #    ###  ##      
   #   #              #  # #      #  # # ##  # #   #     ##  #  #   # #    ##     #      #   #  #  # #  ## #  #   #    #     # # #   # #  
#           ## #                    # # ###    #    #   # ### ### #  #   #    ## #    #  #    #  ##  #  ##### #    #  ##     # #   ##     
  #      #    # #    ###     #         # # #       # #     #  #     #         # ### #   #       #####  #   #     #           ##       # ##
    ##   #          #  # ##  # ###  ##  ###    #   #       #  ##    #   #    ##  # #           ##    ##     #        #   ##    ###  #  #  
  #   ## ###     ###   #                  #   #       # ##    ## #   #     ##  # ## #  # #   ##   #   ##  ####  # ##  #  #  ### # #   #  #
  #   ###      ###   #  #     # #  # #    ##  #   # #  ###  # #      #### #  #          # # # #    #     #             # #            #   
    #  #      #####  # #     ###   #   #  ## #                #   # #        #   #  # #     #  #  #   #  #  # ### # ##  #   #     #  ##   
 #     #  ###        #  #  #  # #      ##       ### # # # #  # # # ##    #     #   ##  ######  #  #  #      #####  #     #   #       #  # 
#  #  # #    ### #  # #  #  #  #  #    #### #   ### #  ##  #    #  #             #            ##  ##     ## ###  #        #    #      #   
  ### #         #     #   ### #  ##          #   ## #####     # ##  #    ##     #    ######  ##    #  #   ## ### ##  ###  ## ##  #  #   # 
 #  ##      #  # # #    ###  #    ##   ##### #   #   ##      ### #   ## ##  ## # ## #  #  ##       #  #  #      ##    #   ##  #       #  #
    ## ### #       #      ##  ###    #          ##    ##     ##   #   ###     #    ## #      #          #  ## ##  #    #       ##    # ###
#       # #     ##   ## ##  #  #  # #    ##  #     ##    ##  ##   #  #     ## # #         #         #   #    ## #  # #    #    # #  ###  #
#           # #       # # #   ## ##           ##   #    # #  #  #  # ##### #  #   #             # # ##     #  # #  ## #         # #  #   #
 #    #   ## ##  ##      #    # # # #  ## #     ### ##  #   ##   ####      # #  #  ####     ## # #   # ## ##        ## # #        #      #
      # ## #      #  #  #    #     #  #  #E  #  #      #              #  #       #  # #           # #   #       # # #  #      #  ###    # 
##  #   #              # #   # #     ####   # # #   ###    #     ## #      #              # #   #    #     #      #     # ####### #       
    #     ####  #  # #  ##     ## ## ##  #   # ##     ## # ##    # # ####       ###   ## #       #  #   ##     #   #  #   #   ##  ##  #   
#                 # #  ##  #     ##   # #        #         # #    #      # #  #      ##   #  #  #                 # ## #      # # # #   ##
#  ##   #    ##   #    #       # ###      #   ## # #####     #                   # # # #### #  #  ##      #  ##       #   #  ##       #   
          ## #   ####      #  ## #  # #       # #    #   #    #       # #   ##      # ## # ##     ##       # ###     ##   # #      ## # # 
      # ##   #  ## # # #     #          #   #    ###   # #    ## #  #          #  ##  #   #   #        #  #  #  #   #    ##  ##  #   #   #
   #  #   #  #    #   # #       #      # #  ##    #   #  #  #     #        #    #       # #  # #        #      # # ##    #   #         #  
 # #  #   # ##  # ##      # # #     #   #     #              #      # #  #      #  # # # #  #     ####    #  #       #    #  ###      #   
  # #        # # ###    #      #### #  #           #         ## #     # ##   ##   # ## ####   #    #  ##           #  #   ###     # #  ###
       # #     #     ##     # ##  ##   #  ##  ## #     #             # # ## # #   # #  ####  ##    # ## ####    #         #         #    #
#    # #       ###    ##     #  #         # ##   # ###   #   #            ##        ##      ## #  # #         #    #   # #       #  ##### 
          ### #   ## # # #     #  #  ## # # ## ###   # #      # ####   #   # ##        #    #        #  #   #  #   #    ##  #  # # #      
#   # #   #       #    # # #    #       #  ##  ### # # # ##  #   #  # ### # #    ## ###         ##   #   #    ##       #  #    #   #      
#  # #    ##      ##     ## #  ## ### #     #  ##  #  #      #   # ##    ## # #             #  #  # #      #     #   #  #        #  # # # 
## ##  #  #  #   #  # # #  #              ## # ## #           #####  ###    #  # ## # ### #      # #  #     #    ## #    # ##   ##     # #
#    #    ##     ###   ##       #### #   #     ##    #        # # #       ##     ####   # # ## #      ## #       #  ##     # # # # #   ## 
   # ##                   # #    # #### ##   ##       ## ## #    ###        #      #     #     #      ##  ##  # ##   #  #    # #    ##  # 
   # #  ## #   ##   #    #      #      #    # #   ###      ## ##   # ##   # ## #   ##           #   #      #   ## ##  #   #   #     #     
# #  # # ##  ##  #  #   #    #   #   ###    ##   ##   # # #  ####      # # # #  ## #    # #   ##   # # #  #    ##  #  # #  ###          # 
   ## #      ##  # # # #  #  ## #   ##   #           #             # #          #      # # # # #   #              ### #      # ###      # 
# #    # #    # #  ###    #  # ##   #           ###    ##  ##    #    #   ## # ##   ##  # #   #     ##        #####    #   #           # #
 ##      #     #     ##         ## #    #    ##   #     ##      ## #  #        ## # # #    #        ##  #   #  # #    #     # ##     #    
  # # #      #   #    #   # #     #  #        #   ##    #  #          #        #    #       # # #      #  ## ### #    #   #    # # #  ## #
   #  ### #  #          #           # ## # # # #   #  #    # ## # #  ##     #  #      #           ###    #       #  #     #    # #     ## 
       ### #  #      ##  #   ## #  ##  # ### # #  #  ##    # ##   #### # #      # #      # #       # # ##   ##                 #          
#   ## #  #  #    # ##     #     #      ### #      ###  # #       #    # #         # ##     ## #            # # # ##     #        #   #   
    ## ### #  # #  # #   #     #     #      # ## ##    ##  #  #          #   ###         #        # #  #        # #       #       #   #   
  #   #     #  ##  #   #  ##   ###                #   # ##     #  # #    #           ## ##    #    #     ###    ## #    # #      #        
   ##   # #         #    ## #    #   ##     #   #    ### #  #   ##   #       #                #   #    #  ###   #   ##    #   ### #   #  #
  # #  #  ##     #    #   ##       ## # #  ##         # #   ## #      # #      #   ##    ##  #  #      ## ##  # ##  # # ##      #    # #  
        #   #  #       # #   # # ## ##   #    #   #      #                ##    #     # #      # #   #  #      #          #        #   #  
 # ###     #     ###    #       #   #       #      ##   ##          ###    ##    #     ##  ##    ##     ##   ## # ##    #     #    ###    
       ##   ## # ##   # ##      ##  #    #   #  # #  ##        #     #   #     # ## # ### ## ##   #   #  #     ##    #    #        ## #  #
  #       #   #   #       #   #  #  #  #   #        #  #      # #     #  #  #       #     # # #     #  #####        # #   #      ### #   #
  #             #   ###    #  #  # # # #  ##  # #    # #   #   ## ##     #        ##  #  #        #   ## #     #    # #               #   
#  #  #    #      ##  ##       #    #     #        # #     #                 #   ##   ##  # # #          # #  ##        ##  ##     ##   # 
 ## #     ##   # #     #  ###      # #  ## # ## ##     ##  ##   # ##    #  # # #    #         #   #     # #   # #   #   ##  ###   ##  #   
##       #   #     #               #    # ## #  ## # ###  ##   # #    #    #  #  ##  #   # # #    #        #  #  ## ####  #    #    ### # 
   #     #     ##    ##   #     #  #                   # ##      #    # #  #  #   # ##  ### # #    #    ##         # ##    #  ##       # #
       # #  ## ##  #            ##    #     ### #    #         #    #    # #         #### #    ### ## #  #  ##  # # # #    #   # ## #  #  
 ##    ## # #      #  #      #   #  # ##  #   #    ##  # #       # #      ##          # #            ######   #   #   # ##    #    #  # # 
         #  #     # #  # # #    ## ##  #        ###    #      #     #  ## #  #    #      ###  ###  ##     # #     #   ####     # #   ###  
##   ###  #        #   ### #    ##      #    ## ##  #    #       #          ##  ## ###     # ## #     #      #    # # #   ##   ##         
 ##  # ##  # ## ##           #  #    #  # #    ## #          ## #  # # #  #    ##   #####         # #  # ## ##         #    #   #  #  #  #
#   #    #   #   #  #    #  #  #    #  #     #       #   #                #    # #  #    ##   ##  ## #  ##    #        #   ###            
##  ### ## #  ## ## ## #  # #  #  #  ###       #     #   ##     #        # ## #     #     #  #  #   #   # ##    #    ###  #    #        # 
