 #    # #     #  #  #         ## ##       #  #   #     # # #   #      ## # #  #  ## #  # # #    #  #    #          ## 
 S   #     # #  #         #      ##   ### #    # #  # #      #  # ##            # ####   #    ###   #    # #        ##
#     #    # ## #####         #       ## #     ###      #       #  #      # #  #      #     #     ##   # #   #  #  # ##
   #   ## #     #   #      #    #  ## #      # ## # #     # ##  ##     ## #   ##                ## #  # #   ## #   #  
 #     # ###      #   #    #  #        ##  # ##     #   # #    # #      #      #     # # #    #   #   #  #    #       
 #   #  ##      #  ####    ## #   ##  ###  #   ###  # ### # #    #  #      #  #  ## ## # ##    #   #      # ##   ## ##
# #  ####     ####       # #  #      # #  #  #     # #### #      #  #    #  ### ##       #  # #   # #  #   # ##   #  #
# ##      #       ##      #  # #       ##  #               ##    #      ### #    #   #  #          # #    #           
      # #     #    #   #   ## ##   ### #        #      #  #      # #  ##  ## #   ####  #     #####    #    ##         
    #     #  ##  # # #   #   #   #    # # #  # # ## ## ##   #           #    # #  #   #         #####  #    ## #    # 
   #    # # ###       #   #    ## # # #  #   #  # #          #  #   #  ##  # ###       ## ##  # #      #    #         
  #  #  # #    #  #    #    ##   ##     #             ##  ##      ##### #   #       ####   #     # #         #     #  
   #     ## #    #      #  ####    #  # ##  #      #      ## ##  #    #   # # ## ## #  # #  #   # ##        ##        
  #  ##            ###          ##   #  # #  #       #  # #     # #  #     ## ##        ## #####    #      #   #   ## 
 #  #  #  ## #           #        #  #  #   # #        ## #   # ### #  ## #  #  # #  #  #    #  ##  # #    #    ###  #
#    # ## #  #              ##      ##  ##  #          #   #   #####   #  #      #               #   #  #      #  ##  
  #  #    ##  # #  #  # # #  #   # ###  ##   #   #  ####         ## #       # #        # # #   #          ###     # # 
 ###   #          ### #     #         #   ##  ##  ##   ##    ##      # # ##  # #  #    #  #     #  ##       #  #  ##  
   # #    ##  ##  #  # ### #   ## ## ##     # # ###  #    ## # ##     #   #        #  # ##    #  #  #  #  ##  #       #
 # #  #    #      # ####  # #         ###             #   ###   # #    # # # #  ### ###   # # #### ###        #   #  #
   #  ## #     ## #  # ####   ## # # # #    #  #              ##   ## #####              #  #   # #     #   #   #    #
#         ##     #  #     ##      ##   # #  #     #  #    #    #     # # #  #  # ## #  ##     ###   ##   #   ### # #  
 #     #      #  #  #     #    #   #   ##       # # #  #    #    ## #      # ## # # # #         #  #    #    #  # # ##
 ## #   #    # #  #          # # #    # ## ##   ##       #       #     #  #  # ##  ## #       #   #  ##  ###  #     # 
  #  ##   # ##   ##  #       # # ###  # #  #   # #        # #   #  # #  #     ##  # ### #            ##    #    # #  ##
    # ###   ####  ##  # #   # # # #              #    ####    ## # ## ## # #  #    #  #  #  #  ##   #   #  ##  ##  #  
 ## ##  #  #        #      #      #         #    #    # #      # ##  #  ##   #  # ## ## ##   #  ###    ## #  ## ##    
       ##   ### #  ####       ##     #  ##         #        #        #      SS   #  #   ## #      ### ## ###  #     ##
#     #  #  # # ##  #  ## # ##     #   #  #    # ##    #      #   #             ## #   ### ##          ##     #  # #  
#     #    #  # # ###     # ##  ##         #       #    #    #   #             ##  # #  #        #   #    ##   # # #  
      ##  # #  #        #  #E##  #    #        ## #          ##    ##        #   ##  ## # # # # ###   #  #     ##     
          #   #  # #       #  #   ##   #                # # #  ###     # ### ##        #        ##   #     # #    #   
#    #     # #     #  ##                  ##   #       # #  #  #  #  ## #   ### ## ##  # ##    ### #   #  ###        #
   #  # # #       #  #     #  #   #  #    #   #    ##     #  ###      ## #   ####     ##  #   #      #  #   ###     # 
   ##  ###    #   ##     ###        ###  # #     ##  # ## #               ###  # ## # #    #   ####              ##  #
 ##         #          #   ##   ## #  ## # #   ##  # # #   # #    #    ###    # #    # #    #             ###  #   #  
   #         ## # #  #    #   ##    # # ##   #   ###        # #  # ###       ##        ##   # ##  #  # ##             
    #     # #  # ###    ##   #  # #    #    ##  ## #          #     #   # # #     #    # ###   # #    # # #      #    
 #  ##       #   #   ####    #  ###     ###    #  # ##  ####        #   #  # #    #   #   #   #  ## ##  ##  #  ##  #  
#88
#