   #      #        # # # #   ####   ## #       #         # #    # #  ## #          ##    ## ##    # #     #     # #     #   #   #     #    ##          ##     
 S#   # #  ###   ##      # #  #   ###         #  ### ## #   ## #  ## ##  #     #      #  #       # ### #     ####     ##     #  # #          #        #   #   
     #  #  #  #        ####  ##    #  # #       # # # #  ##  #  ##       #  # ###  ### #          #  # #  # #   #      ##   #   #    #    ##    #  #  #     # 
#         ## ##      # ### ##   #    #         ## # #  #      ##     # ## #  ##  # ## #   ## # #   #   # #  #       ##             #  # ## ##         ### ##  
        #    #  # #     #  #  ##  ## # #     #   # ##  # # #   #  #   # #   #   #      #    #  #     #        #  #  #   #   # ###   ##   #      #  #       #  
#        #    #   #       # # #    #     ##   ##   #   #    # # ##  #   ##    ####  ## #   #    ##   ##          #  ## #  ##   #   ### ##    #  # # #  # #### 
 #   ####    #    #     #   ## # ##########  #         #     # #   #            ####  #     #      #  # ## ## ##  # #       # #  #     ##    ## ##         #  
 #   ##       #     ##      ### #  ## ###  # ##    ##     ###   #    #  # # # ##  #  #       ###   # #   ##  #     #       # #          #  #  ##   #  # #  #  
## # #    ####    #    #           ## # #  #       ## # # #  #  # #       # ###    # #    # #  #  ###    ###  # #   #     #   #    #  #     #     #  # # ##   
    ## ##        #      # # ####  #    #  #      #    #           ## # ##  ##      #   #  #  #         #    # # #                #  #             #   # ##### 
  ###     # # # # ##         #      # #   #    # #     # # # ###          #  #  ### #   #  ##  # # #       #   #    # #     #     ##     #       #       ##   
  ###     ##   ##    #     #  ##        #    # # # #   #     #   ##   # ##     # #   #        #           # # # #   #       #    # ##    #       #      #  # 
#    ## # #   # ## ### #  ## #   #    ##  #   #  #  # #     ##     #      ## #       #   #  # #   #           #  # #             ###          ## #     ##   # 
#    #  #  # # #  #    ##   #    ##  #       ##     ### #      # # ##      #  # # #         #  ##  #    ##   ###   ##  #     #     #   #      #  #           #
  ##            #    # ##     ###    ####     ## #   #  #   #     #    ##    #    ###     # ## #  # #     #  #      #       #    # #  ##    # ##   ###       
        #     ##  #      # ##    #  #  #   #      ##  #  #       ##     # # # #      # ##   #       ## # #    #  ###  #     ##     # #     #         #     #  
     #       ####   # #   #   ###       ###    #   #      #  #  #   ##  #    #     #     ### #      #  # #   # ##   #             ##  #    # #   #  ## #    # 
      ####      # # #      #   # # ## ### ## #  #  # #      # # #  #### ##          # #   ##  #     ##    #  #         # #        #  # #     #   #        # ##
  #       #  # #   #  #  #  #          #      #     ## ## ##  ###    #       #            #     ##  #  #      ###   ##  #    #   #  #   #    ###  #  ##     # 
      # ##    #        # ## # # #                #    ## ##  #    #   #  ##  # #       ##   ###  ## ##   #  ###  ##  ## # ###          ##    #  #  # ##  #    
#        #      #      #  #    #  # #### ## ###   # # # #                 ## # # #  #   ###  ##    E #   ##  #      ##    # ##   #    ##     ###  #     #     
  ## #       #               #      ##       # #        #  # #  #      # #   #####    # ### #  # #           # # ## ### ##         # #    ##  ##    #  # ##  
     ###    # #    # #  # #            ####   ## ##  #  #   #                     #  #  ##     #   ##   #  #      #  ###  #    #  # # # ####   #     #  # ##  
### #  ##  #       #    ##   ##    #          ##      # ##  ###        #       ##### #    # ##  #  #          #         ##             #   #      # ##  #  #  
#  #     ###       #  ##   #   #### ##        ### # #         #     #        ##   # #      #    #    # # ##   # ##  ##        ##    ## ##        # #   #     #
     ##     ##   #   ##    ##  ##  ##  #   #    #                     #     #  ##  #   #      ## #     #   #  ##      # #  #  ### ##     #  #  ## #        #  
 # #       #### #  #         #       #   ##  ####      ##  # ## # ##           # #      #  # #  #  ###        #     # # ###  #    ##   #  # #   ## ##  # #    
       ## # # ## #####  # # ## # ### #       # #       #    #  #  #     ##    ### #  #  ## ##  # # #  ######   #      # #  #  # #      #   ### ####  #  ##    
 ###                ##  ### ## # #   #           #  ##  ## #     ###    ##              #   #       #    #  #           ###     # #     #         #      #   #
     #     #    # p ##   #     #  #  ##    #   # ##   # #  #      #       #  # # #    ##   #     #  ####     ##    # #  #    #   ##   #  ####  # # #          #
#  ##   ## #    # # ## ###  # #   #  ##   ##        # #   #       # #      #  #   #  ###         ##       # ###  #   #   #       #    #        ##       ##   #
 #  #     ##    ##  # #         #      #  # ##  # ##   ##  ### # ##  # ### #        # # #  #       #       ##   # #    ## ###   #  #    #  #         # ##     
   ##    # # ##       #    #   # # #    # #      #   #   #              #     ####  # # #  ##  ##  #  ###    # #      #  ##    #     #    ##     #  #  #  #  #
 #  #  #  # # ####   ## #  #  #        ## #### ####  #     # ##         #     ## #      # # #   ##         #  #       #  #      # ##          ##     # #  #   
     ###  # # # ## ### #      # ##     # #  # #  #    ## ###  #        #    #   # #   #        #           #     #    #   ### # # #   #   #   #   #  #   #    
 ## ##               #    ##   ## ## ##    # ###  # # ##  #  #    #   #          #       #    ##   #  #      ##   #     #      ## #     #  ####  #   # #   #  
   #         # # ##         #  #       #  #    # # ##   ##  #    #    #    #        #   ###   #  #  # # # # ## #  # #     #     ##      # ##  # ##  #    #  # 
            ##  #        #   #     ##      #    # #   #    #  ##        # ##   #        #       #      #    #     #      # ##    ##       #  #   #        #   
#         #     ## #### # ###         ## ### ###   # ##       # # # ##    # #        # #      #####    #####    ## ##  ###     #   #     #             ##  ###
## ## #  #     ### ###       #   #  # ##        ###  ## # #  #    #    #      #  #   ##          #     #   #   # ###   # #  ##     ####     #    #            
## ###  #  #    ## #  #  ##  #   # ##     #          ##  ###   # #    # #   ##  #      #   #    #       # ##  ## #  #    #  #    #     # #           #        
    #   # #     #  ##   #     #   ## ##  # #    ###  #  # ###  ##     # #  # #     # ##    ## #   # # ### #  # ## # #   #     #     #   # ##   # ##    #  ### 
#  # ##   ###    #    ##  #  #    #   ## ### ##  # ##  # # # # # ##  #   #  ###   # #     # ##         # #    # #    #   ##       #      ###   ###  ##   #  # 
# # ##       #    #            ## #    #  ##    ##  #  # #  ###   #        #  # # #  #      # #  #        # ####    ## #           ##  ##    ##   #          #
 ##   #    # #     ##     #    #   # ## #  #  #  ##   #   # #  ##  #  #        ##    # #   #    #   # ##     #           #    ##      ##  ##     #      # #  #
# # #    ## ##########  #  # ##          # #  #  ##  # # # ##     #     ##     ###  #    ## # #  ## ##  #       #   #       ##  ####    #  #   #   #### # #   
   ##   ##    ## #          #    #    ##  #   ###     #     ##   ##    # # #         #   #  #       #      #   #          #     #              ###  #####     
  ##  #      #    ##        # #    # # #  ### #       #  # #       ## #   ## #   #   ## #  # #   ## #   #      #  # #  ##   ## #   #   #   #           #  ### 
    #### #   #    # #  #        ##  #   ###  # # #  #    #      #   ## #     # # #           # ##   ##     #   #  #  ## ##    #        ##   #  #         #    
     #  #         ##### ## ##   ## #   # #  #        ## #   #   #               ##      #   #    #  ## # #    #    # #      #   #       # #          # #   ## 
      #      #  ##            ##           #  #   #      # ##         #    #            # #  #        #               #          #  #### #  #            ### #
    #    #  # ##        #        #      #  # ### ##      #  #     #      #  #            #  # # #   #   #      #### ##   # #             #   #    # # # ##    
   ##     #    # #  ##    ## ###  ####    # ##  #     # #       #       #    #  #       #  #  #  ##    #   ##  # #  #         # # ###  ## # #      # #  ##  # 
#    #       #        #  # ## #        #      #  #  ##          #  #   #  #  ##           #      ## ##  ##  ##     #    #    # #    #    #  # ###  # ### #    
 #### ####       ##         ###  #     #     ###        #   ##     ## #    ##    ###    ##### ##      ###       #  #         # #   #       ##        ##       
 ##  ###  # #  # #      # #     #  #     #  #  #   #  # # #    ##        #         ## ####   #### #        #    ##   #     #  # #  # #     ##  #  #          #
    #      #    #  # ##  #             ####  ## # #                ## ## ##              ####   #    #    #    ## ## ##     #     # #  ##        #          ##
#   #  # #        #  #     #    #  #  #####   # #   #       # ##  ## #### ##    ##  # #  #             #        ##   ##    #### #   #  #  #   ##           ## 
      # #  # ###     #  #  ##  #  #####   # # ####   #     #    #  # ### # #      #    # ##     ## # ##   #  ##    #  #       #   #  #  #  ## # ###  #       #
       ##   # ## # ## #  # ####   #   #    # ## #    #            # #        #   #        #  #      #  #  #      # #    #      #   # #  #     ##    ### #     
 # #    # ###   #### ## ## #  #  ##    #    # # ## #       #   ## ##    #             #   ## ####  ##  ###  #       ####   #   # ###    ##   #  # #    #  #   
        ##      ## #  # #    #   #    ####   #  ##  ### ###        ## # #    ### #      # ##   #  #   #          #    #    #  # # #       #    ## ###     #  #
      #    #  #   ## ##     ##         ##   ##   ## ##  #   #     # #     ## # #    ## #       #  # # ##  #    #     ##    #          ### # # ###        #    
 ##   # #### # ## #   #       #    #     ##  ###  # # # ### #####    ###   #          ####  ###  #      #                  #   #   ##  #      ##  #  # ###    
   #    #  ## #    ## #  ##        #         ##  # #   # ### #   #      #   # # # ##    ###  #  #  #  #      # #      #  # #  # #    ###  #       # # #     # 
      #           ###      # #   #     #  #  #   #  #       #      ##     #    #   #  #  ## #     #       ###   ##  # ###  #      ##       #   #  #  #    #   
  # ##    ##  #  ##  # #  ## #   ###    # #   #   # # ##                  # ## #  # # ##     #      ## #  #   # ##  #   # #       #   ##   ###  #       ## # #
#    #    #          # #   #  ### #             #   # #       #  # ### ##  # #         #    #   # ###  #      #   #  #   # #  #    ##  # #     ## ### ##     #
#  # # #   #   #     #    ##           ##    #  ##          ##  # #  #        # # #  # #  ###     ##     #     # #    #   ## ##  # # #   ####  # #         #  
    # # #  ##   #    ## #  # ## #   #  #     #    ##      # #    ## #    #      #      #  ## #        ##     ##         #  #  ##     # # #     # #   # ##     
  # #             # #      # # ### #    ##   #    # #   #    ###     #   ##    #      #   ###     ###  #### #  #     ## #            #   # ##     #           
   ##  # #  #    ###  # #  # #    #   # #     #####  # # # #    #   # #  #   #  ##    # ##   #   ## # #      #             #    #      ## # # ##  ##     # #  
      # #   #  #    #     ##  ###  ## #   #  # ## ##  #       #      ##  # #    #   #   # ####  ###   #    #  #      #########  # # #    ##      #   # #      
####    #    ##  # #  ##  # #    ####  #       #      ### #  #       #   # # ## #  #  #   # #   #  #  # ### #        # ## #  #  # #        #   ##    #  #  #  
 # ##### #  # #   #  #    # #     ##       ## # #  ##### ####  #    # ###  #  #  ##  #  # ## #      # #    # #     # #   #    #   ##   #   #     #  #   ##  # 
#   #      ###         ##  #   ##     #    #                #    #       #     # # #   #       # #               ## # #  ##   #     #          #  #  ## ##   #
##      #   # # # #   #####   ##     # # #   # ##   #           #  #   ## ######      #     ## # # #    #  #     ##   # # #    #     #        #  #   #     #  
  ####    ##  #### # # ## ##     #     # ##        # #    ###    #   ##    #  ##   #    #  # # #  ##         #   #   #      #  #  #            #      #   #   
   #  #                       ## #    #    #  #   # #       #    # ###        # ##    #  #### #### ###  ### # #   ###    #   #     #    #   # #    ##    #  # 
# # #    # ##   #  #   # ##  ##  #   ##     #         #  #        #  #     #                #      # ##  # # #  ##        #     ## ## ##    #    #   #  #    #
   # ##  ##  # # #     #    #####       ## # # # #  #                ####  ##     ##   ##   #  #     ## ###      # ##    ####                 ### # # #  #  # 
  ##    #    # ###  #  #       #          #  ## #         #  ##    #    #     #       #             # ## # # ##    #     #           # # #  #  #       ##  #  
#     ##         #  #   ##        #  #   #   #      ## ## #     #   #  #  ##  ####  # # # ##    ##           ##        #  #       #  #       #   #   #    # # 
 #    ###        #  ##      ##        # # # #       #  # #       ##   ###  #      #  #    ##  #     ## ##   #  #  #    #####  ##  # #     #  #  #       #  #  
 #  # # ##   #  #### #   ###    #       #    ### #     #  #    ##           #   # #    # ##    #     ##  ##       #  ##   # #    #     # ## #  # #     #      
   #    #  #   ###   #            #  ## #    #   ## #   ##   # #       #    #       #  #   # #       #####  #     ##     #  #     ##  # ##     #     ## #   # 
       #  ##         #  ### #     # ## #  ###      # #### #  #           ###  ###  # #    # # #  #  ##  ###    #  # #  # #  #  ## ####   ### #  ## #      ## #
     #   # ####   # #  ##         ##  ##      #   #    #  ## #  #  #  #       ###    # #     #     #######        #        #     #         #    ## # #   ##   
###  # #   #     ######   #  # #     #  ## #   ##      #### ###    # #  # ###     ## ##      ####       ### #    ####       #    #      #  #          # # #   
#        # #   #  ##   ## # #  ##   #  #  ###        #     #         #                  # # ####          ##  #  ##      # #  # ## ###   #  #  #     #  #   # 
 #         #      ##  ###   #   # #    #   #      #    #      #    ### #             ###         #      #  #   #   #       #       #        # #     #  ##    #
  # ##   ##   ###       ##    # ####      # ###    #  ## #          #    #  #    #   ## #  #  #   # #  #  ##       #  #  # #     #### ###    #          # # # 
#     ###      # #    #  #        #  # #      #  #    # #   # #    # #  # #   #  ##    # # # #  #      ##           ###  # ##        #             #  # ##    
# #           ##   ##  # #  ### # # #   ##     # ##   #   #  ####  #  #   ##      ## #   #  #      #  # ## #       #    # #  ### ##### #   ##   ##   #  ###  #
      #    ####  #      #      #        # # ##  #       ##    ##    #   #   # ##        ###     # #  ##    #     # # ##     ##  #  ##   # ## #    #  ##    #  
       ### # ###  # # #   #  #   ##        ###   #    #    #  #   ## ##    #    #   #   ###   #    ## #    ##   # #    #     #           #   #  #  #  ## ###  
      #    ##  # #  #  #           ##   #      ##  ##  #   ##       ## ###     # #   ##       #   #  #   ###        ##       ##  #    #    ###      #         
   #        #  #          ####     #### # #      #       #     #     #  #      #  #  #  # #   #   #    # #      # #     #        ## # #      ##   ##  ## #   #
# #   ## # ##  # #     #        ##      ##     ##      #       #     # ## ####      # ##     ##  #  #     ##      # ## #       #  #   # # #   #          #   #
##  ##   #     #   #  #   #   #  # #  # #   #  ##   ###  #    ##  ##  # ##              # #    ##   ##  # # # #    ## #####  #  #  #      # ### ##     ##     
     # #    ##  ##   #  #    #        ##    ##         # # #   ##    ## ##    ## # # ###   # #       #    # ###  #    #   ##    #   # #   #     #  #          
 # ##   #     ##      #  # ##   ##  # # #   ##### # ##     #    ##    ####   #            #   #  ##  ##     ### #    # #   #  ##   ##  #  #  ## #    #    # # 
#    # #  ##         # # # #  #  ### ##    #     #   # #  #  #     ##  ##   ### ### # #     # #  ## #       #     # ## # # # # ### ##        ###   # #       #
#         ## #     #        #       #  ##  # #  ##  ##   ###        #     #            ##  #    # #       # # #          ##  #  ##   ##  # ## #     #      ## 
    ##       ## ###  #  ## # # ## # #  #  #  ###    ## #  # #  #     #            ##      ## ### # #  #       # #    #   #   ## #        #   ## ## #          
  ## ## #   #  ##        #    # #      #   #   #   #     #      ##   #       #  #        # #   #       #  # ####   #  #    #   # ########    #   #  ##   ##   
