##  ##    #  #             #  #         ###
#  #    #   # # ##  # # #   #  #  ##      #
# #####     #  #      #####     # ####   ##
 # #      E   ### #   # #   #     # ### #  
#  #      ###  #  ##    #                 #
#  ####  # ## ##   #  #  # # ##  #     ## #
 #  #   ##           ### ###    #      # ##
  ### #  #     #  ### #  #     #   ###  ## 
  #     #  #   # #    ###        #      #  
  #         # ## ### ##      # #  ## # ##  
 ## ##  ##   ### # #   # #  ##        #    
