 #    #      #      #  #  # # #  # #  #       ##   #   ####
    ## #    #            ##  # ##         #      # #  #  # 
# ##   #     # ##  # ###  #  #    # #  #   #   #   #       
# ###       ##   ##         # #    ## #  ##      #      #  
 ### #    #       ###  #     ##  #         ##  #           
#     # ### ##     #  # #       #     #  # ##     ##    # #
#      #    #    #     #          #    #   ##    ##  # ##  
#      #     #    #   ##           #  #       ##        ###
      #   #  #    #  #   #  # #           # #    ##   #    
 #    #    #    #             ##  # ## #  # #   ##  ##    #
  #   ##           # ##       ##   #    ###      #    #    
 #       ##    #  ##     ##  ##  #  #    # #               
  # #       # #  #     # #            #  #   #  # ## #   # 
     #   #   # # #     # #  # ##  ##  #  #     ##   # ##   
     ## #  ## ##  # # #    #    ## # #    # ##   #    #  # 
   ##   ## # #  #      #   #  # ###  # #  ## # #     #     
# ##  #  ##     # #     #  #   #   ##     #  #           # 
   ##      #   # #  #   ####  #   ##      # # ##  # ##    #
#    ###               # #     #     #            ##      #
### #  ####        ## # ## ##  ##   #    # # #          #  
 #  #    #    ###  #      # ##  #            #   ## #      
   # ##   ##  # ##                 #       ####   #      # 
    ##  # #   ##  ### #  ##  #  #   # #  #  #   ###  #     
      ##   #   #    # #  #     ##   ##    ###      ####   #
          #     #  # #                # #  #  #   #    p#   
   #        # #      ## #       # #   #  #   #     #       
   #    ## # #        # #    ##  ##    #    #    # ## #    
##   #  #    #    ##       #  # #####  # # ##           # #
     #  # #         # # # #  ##  ## ## ##   ## ## #  ##    
# #       # #      #     #   #  #  #  #      # ##   # #  # 
  #       # ## #  #       #        #   #            #    ##
# #  #  # # # #  ##  #    ##  #       #         #      #   
  ##  #        #    ## #                           #      #
    #   #   # # ## # #  # ###  ##    #  #      ## ##     # 
    ## # #   ##  #       #  # #    #      #     # #     #  
  #  #  #   ##    ##    #       #    ##    # ## #         #
##  #     ##       #        #      #   #  #  #     #      #
        #### # ###          ## ####  #      #     #   ###  
# ##     ##  ##  ##    #     ###         #  #    ###       
  # ##  # #      #   #   #   ##    #    # #  #   ## #    # 
           ## ###  # # # #      ##   # #            ###### 
 #       ## #  #  #     #    #     #         #  ### #  #   
        # #   #  #   ###   #      #  #    ##    # ###    # 
#    #  ##         ##      #   #   # #   ##  ##            
  #      #        ##      # # #    #  #     # #     ## #   
     # #   ## ###  ##### # ##  ##### #   ##  #           # 
 ####       #        # #     #           #           ##  # 
 #    #         #   ##       #     #        # # #  #     # 
#      ##  #   # ##  # #  ## #  #      # ##  ##       #  # 
 ## # # ## #    ##                # #####      ###   #  #  
    ##  ###   ####      ##    # #  #     ##     #  #  # #  
   #  #     # #  ##    ##  #     ## # ###    ##  #  #     #
      #              #    #    #    #    # # # ### #    #  
 # #  ##     #  ##       # #  #  ## # ## ## #   #      ## #
## #     #    #    # ##    #  # ##  #    #     ##    # #  #
 #    #         ##   # # #      #  # # #  ##         ## # #
