  #   ##     ###  # #   # ##       ##     ##      ## #      #   
 S# #    #    #     #      # #      # # #   #        #    # # # 
  # ###   #  #    #####  ###          ##  #    ## ###     # #   
    ##          ###   #   ### ## ###   #   #       ## ### #    #
    # #  ##   #   #      #  #  #   ###    # #   #  #  #     #  #
#  #  ##      #        # ## # #    #   #  #    #    # #    #   
 #  ###  #      ### #    #   ###  #     #    ####      #        
#     #  #   #   ## # # ## #       # ###  #   # #      # #     #
    ##    # #  #  #  #  ######      #    #####   #   ### # ##  
# ##  #    ##               #      #  #  ##   ## #     # # #    
# #       #  # #   #    # ######    ####    #   #  #    #####   
      ###  ## #####   ##  #    ## #      #  #      # #   #  # # 
##     ##      #   #     ##  #      #     ##    ###      #  #   
 #       ##    ##    ##        # #  #  # # ##    #    ###    # #
       #  #    #  #  #   #    #  ##   ##    ## #              # 
  ##      # # #      #  ##    ##  ####              #  ##     # 
#  #      #          # #   #  ## ##  # #             # # # ##   
  # #    #     ##   #####     # #  # #  #          #       #    
 #   # #  ##  #  ##     # # #        ###  ## #       #  #   # ##
 ##     #  #     #       #     #      ## #  ###  ##       # ## #
 #                #    #         # ### #   # #    #     # #  #  
# #   #  ###p     #  #    # #  # ##   # #      # # # ### # ##   
 #   #  ####   #      ###     ## #  #     ## #         ### #   #
   #    #     # ##       ##  #      ## #    #       #      #  ##
#  ###   #      ##               #    #   ##  #  # ##         # 
     #  ## #     #     ###   #  # #### #    #    #        #  #  
#   #      ####  #      #   #        # #   ##  ##     ##   ###  
  #    #   # #     ##   ##         # ##   ###  ##      ##       
#         # #   #     ###   #    #  #        #    #     # ## #  
  #         ### ##     #  #   #####  #  #        #  #    #  ####
#      # #  ### #   ##     #   ##   #  #  #      #  #       #  #
  ##     # ####          ###   ## ## #   ## # # #       # ####  
    #     ###  #  ####  ##      ##   ##           #  ##    # #  
 #        #     ## ## #    #   # #    # #  #  #    #     ### ###
 #    ##       ####  #   ###  #       #      ##   ####         #
 #   #  #    #    ###   #  # #  #  #  ## #  #   #   #     ##  # 
     ##         ##      ##    #   ##  #       #   ####  # ##    
# #   ##     #  #  # #    #      ###   #       # ###    # ### # 
   # #   ## #           # #   ###  #     ###  ##   #     #    # 
 #  # ##    #      #   #   ##    # # ####   # #    #  ##        
  #  # # # # # ##  ###      #     ####    # #  #   #####    #   
## #    #     #    #    #    # #  ##      #       #  ##     #   
#   ##   #  #   ##   #  #       ##  #           #   #  ## # ## #
 #             # ##   #   #     ###       #    # ##      # #    
 # #   ##  #  #  # # #  #  ##    ## #     ## ###  # #  #     # #
  #       #      #      #    #         #        #      ## ##   #
      #   ###     ##     # #          # # #               #     
#   #  #      #    # #      # #       #  # #    #     # ## #    
     #  #    ##     ## ##   ### # #   #      # ##   #          #
#    #   # # ##   #      #  #          # ####               #   
    # #     # #    #    # ##         # #####  ##     #       #  
# #     ##     #             #   # #   ## #  #      #   ###   # 
    # ###       #  # #     ###       # #  #       #  # #   #  # 
##  ##     #    #    # #               #    # #    #     #    ##
   # # #  ## #   # ##  #   ##  #     #    #  ## ### ##    # # # 
#      # #    #    ### ##  # # #  ##      ## # #  #     ### # ##
        # # ##    #  #       ## #  #  # # ##  ##       ## #   # 
    #               ##    #  # ##      #   ## #  #    #  # ##  #
## ##        #    #  #  ##   ###          ### ##### # ##  ### # 
      #   #    #  #   ###  #    ## ####   # ##        # #  #  # 
  ##  # #           #  #    # #    #    #  #  # # #   # # #     
    # ##  #     ##  # #    ###     #    #  # #         ## ### # 
# #### #  #    #   # #    ### ## ###         # #  ## ##     ##  
   #   #  ## #     #   # #              ###     #  #    ##   #  
# # ##   ## ##   #    # #      # ##  #   ## ##   #   #    # # # 
 #   #             #       #  ##    #  #     ## ##          #   
  #   # #   #       #  ###    ###          #   #    # #     # ##
  #       # ##  #           ## # #### #  #    ##   ##   #       
 #  # # #           #   ##      #      # ###        #   #     ##
 ##      # #          #     ##      #    ###              #  ## 
     #    E#    # #      #      ###   # ## # ##  #### #     ### 
#    ### # #          ####  #   #     ##    ## # #    ##        
#      ##    ## ###   #    #  #           #   ###     # # # # # 
         #    #   ##   #   ##   #               #     # #      #
 # ####     # ###     #    ##     # #   #      ##   #  # #  #   
 #          #   ###     ## # # #  ####   #  #   ##              
     # #          #  #         #          #  ##            ## # 
# # ##    #   ###  # ##   # #   #  #           #   # #        ##
#  ### #    ## #  #  #        #  # #     ##       ##     # #    
   #  #  # # # #     # #          ### # #       # #    ##     # 
 ##    #    # #     #  #  #   #  ##  #   #  ##       #  #  ## ##
 # #   ##            # #       #   #  ### #    #   #      ##    
 # ##  ##  # # #  ##   ##    #  # #        # #   # #     ###   #
#   #  #  #     # #    #    ##    #  #  ### # ###    #    #   ##
####   #   #    #     #  #           # #        #       #    #  
            ##    # # #  ##     # #  ##    ##     #    #  # #   
   #  # #     #      #      ## ## #      ##  #   # #  #        #
 #   ####    ##     ## #     # #  ## # #      #   #          # #
   # #      #   # #        ###    ## #       ## ### # ### #     
 # #  ## #      #        # ##  # #       #### #  #    #     ####
# # ####    ##        #  # ##   ## ##### #   #       #   #    # 
###                ##   # # # #    ##             #  # #        
 # # ## #          ##      #   #       #       ##  ##  # ##  #  
     # #  ##    ##  ###  #  # #       ## #  #     ## #   ### # #
     #  # #######   #             #  #             ##    ### ## 
#    ## # #     #    #   #     ##    #   #       #  ####  #     
#    #    #  ###       # ##  ## #             #  #       # # #  
## #   # ###  # # # #       ### ##  # #  ###   #    # #  # #   #
##  #  # # #  #     #    #   #           #### #    # # #   #    
      #     ## #  # ##  ### #   ##    ##          #          # #
   ##    #      #    #   #      ######   #   # #  ##     # #   #
 ##  ###    ##   #  #         ##   ##  ## #  ##   ##    #      #
 # # # # ##  # #       # ##  #     ###  # ##   #     ##   ##    
#   # #   # # #     #  # #      ##    #  ##    #    #      ###  
  # #      #   #  # #    # ##   #      #  # ##  # #  ##        #
  # #   #     ##  #      #      ##   # # #      #  #           #
 #           # # #   #  #  #   # #       #        #     ## #    
 #  #   #  #   #  # ###     # #  #       # #  ##     # #       #
   #      ##     #      # #  ## ###  #   ## ##   # ##  # #  ### 
## #  ##   ##   ### ##   #  #   ## # #            #      # #    
      # ####           ####  ##    #    # # #           #    ## 
#  # ##  #       #      #           #  #   #     #     # # #    
   # #      #  #      #   ##    # # #  #####  # # # ## ###      
 ##     ### #         #   ## #               #       #          
#     #  # ##   ## ##    # #  #             ##    # # # #  ###  
#  ##     # ##  #    # #      #    # #  # #  #   #   #   #   #  
      # #   #   #     # #    #          # # # #             # # 
###        #   # #  #  #  #       #    #  #   # #    ## #   #  #
#   #  #  #  #  # # # #   #     ###  #         #          #     
         #     #  # #      ### #     #     ## #       #   #  ## 
 ## #  ## #        ###    # #  ##         #     #     #  ###    
#    #  ## ##     #  #  #         ## #      ##### ##  # #       
# #     #  ## #    ## # #   ####        ##  ## # ##  #       # #
  ##    #   ##   #     ### ### # #   #  #  # ## ##   ##  #      
    # ##    # ##    ###  #    #   #  ## #       # #  #   # #    
##  #     #   #  #     #     # #        #   ## #     # #   # ###
 ## ##  #  ##     #         #  ##   # #       #       # #       
 ##   # ##### # # # # ###       #     #     #  ##  # #    ##  ##
  #        #         #   #     # # #  #     #  #  #        #  # 
   # ##             # #      # # ##   ## #     # #  #        #  
##      ##  # #    #   #      #  ##  ## #             # #  #  ##
   ## #     ##    #    #  #                    #  # ##  #  ###  
    # ##   #  # # #     #  #   #    #       #    #       #      
    #  #       ##   ##    # #      #  #####  # ## # #    #      
                 # #   #    #   #  #  #      #   #   #    ##    
##   #   #  # ##        ##  ###   #  #   ## #  # #  ##       #  
#   #   ##   #      #   # #   #  # #       #  #  ##    #  # #   
       ##      ##    #  #    #        # ## # #    ###   #   ### 
    ###  #  # # ##    ##  # # #  ## #       #          #   # ## 
  #   #    ###    # #  # # ##    #    ##  #          # #        
  # #       # ##  ##   ## # #       #       ## #  ###   # ##  # 
 #   # #       ##       #    # #      ## ##         #  #  # #   
 #   #  #   # ##                          # ## ##      ## #    #
 #                 #       ##          #    # #   ## #    # #  #
##  #    ##      #   # # #    # # #      ##     ## #   # #    # 
  # #        #    #        ## #     ##       #              # ##
 #  #  #  #     ##   #   # #  ##   ##   #    #  #   # #     #  #
 #   #          ###  #   #  # #      # #  #####    #        ### 
   # ##                #   #  # #   #        # #    #   # # ### 
     #  #     # ###  ##      # ##  #   ###    # ## #   ##      #
 ###     #      #  #    ##   #  #  #    #     #      ## # #  # #
  # #  #  ##  #   #    #    # # #     #    #  #  # ## ##     #  
   #      ##      #  #          # #    ### # ## ##  # #   #   # 
   #    # ## ###   ### #  # ###  # ##       # ##       # ###    
# #   #     #    ####     # #   #        #  #  # #   ##   ##    
# # #  #       # ###  ###         #  #    ##     # # #  ###   # 
     # #      #   ## # #   #  #    #     ##  #   ##  # #       #
###    #      #  ## ##   ##   #     ####   #    #   # # #  #    
  # # #    # #  # ##   #   ##     #   # # #   #    ### ##     ##
      # #  #   # # #    #       ##    # #   #  # #    ## ## # # 
#  ###          # #   ##     #        #            ### ###      
      # #  #  #         #      #      # #    #             # #  
#   ## #     ###   ##   #      # # # #   #       # #     #   #  
   #        # # ## #     # #  #  ##    # #    ## # ## # #     # 
 #   # #    #   #   ##  ###  ##    ###    #  #    ##     ##  #  
# #  ###     # #   # #      ##       ## #        #   # ## #   # 
 ##  # #    ## #     # #          #  #    ## ##     # # #     ##
#    #    ##    ####  #           ##  #  #       #  #           
 #      ##            #      #  # # # ##   ##  #  #       # #   
  #      ##   # #  # #  #  ### #   # #       # #  ##     #  #   
    # #  #      #  ###     ##           ####  #        #        
  ## ###   ###   ##   #  #  ## #    #     #    #  #  #  #  #    
        #   ##  # ###  #####     #           #  #  #   ##  #    
   #         #  #   #  #     #  #       #   #   #             # 
#    # ### #  #   ## # # #   #  #          #  #         #      #
    # ##    # #   #### #  ##     ## ####  ##        # # ##      
    # ## ###    # #     #    #   ####  ##       # #       ## #  
#      #    ###   #     #     # # # ##      ##         # ### #  
  # #   #    #  # ##    #        # # ##   #    # ##      #  ## #
          # #      # #  #  ###      # ### #          #      #   
           #   ##    ##      # ##  #  #  #  #    #  #  # # #  # 
   #        # # #  ##   #      ##    # #  #    # ##      #    # 
 # #   # # #  # #  #   #       #     ##    ## ## ##  ##    # #  
    ##   ##       # #        #     #  ##    #   ##     # #### # 
   # # ## #    ##  ##  # ## #  #   ###      # ## #       #      
 #       # #  #    ### #   ## #      ##     #  #   #   #  #  ## 
   # #  ##          ##    ## # # #    #  ###  # ##              
  #    #   #   #        #    #  ### #     ##                    
         ##             #    ###     #  #   #  ## ##     #      
 #   #     #  ## # #   #          #####  ##  #    #  #  #  ###  
#   ##    #      #             ##     # # #   #  #         #  # 
