 #  #   #  #  #          #  ##     #  # #              #   # # #     ##            ### ###      ###  #  #          ## ##    #    ##    ##   #   ## ##  # #  
      #  ## ##  #   ##         ##  # ##   ###    #        ###  #       ##    #            #  #          #      ##      #    ###        # #  ##      #   #   
     #  # #    ### ##    ##     #   # # # #   # #   ##    ##  #     ##   ### #            #    ###       #       #           #    # #     ## #   # # #   #  
 #   ### # ####     #     #          ## # #   # #      #      ###    ### # ##  # #    ## #    #  ###      # #  ##  #             ##  ### ###  #   # ##      
 #           #  #    #    #    ###   ### # # #    #####   #      #   # #   #    #     # #  #   # # ##    #  #    #  # # # ##  # #  #  #  #   # #      ##    
 #  #      # ## #  # #   ### #  #      # #    ##  # # #  # #  #  # #  #  #    #  ### # #  #  #   # # #  ### ## #  # # ## #  # #  ## # ### ## #          #   
  #  #     ##       #   #   # #       #  #     #  #     # #    #   ##  ##   ##    #   #  #   # ## #         #  #   #    #        #   #  ##  #            ###
  ## #  #  #  # # # #  ###  # ####### # ###   # # # #   ##   #   ##     #       #   #        ##   #   ####   #   ##        #   ##      ##       # #  # ### #
#      ##         # #    #  #   #       #  ##           ###  #      #    #        ## # ##  # # #  # #  ###  ##     #     #   ##    #  # #      #  # #     ##
#  #    #    # #  #        ####   ###      #   #    #  #    ##  #  #     #   #    ##   #  # ##     # #       ### ### #   # ##   #  ##   # #     #         ##
     ##      #    #    #  ##  #  #        ##      ### ##        #      # #   ## ##    # #    #     ##  #  #   #     #     #   # ##    #     #      # # #    
 #    #    # # #  # # ## #      #   #   #   #  ## #            ##    #  #####     #        ###  ###       ## #   #            #  # ##  # #  #    #   #    # 
  ## # # #### #  #  # #     ##     #  ##         #    ##  ## ##  ## ## #   #####    #        #  ##     #     #   ## # # ##   ###     ##  # #  # # #   #  ###
#     ##       #  ##    # # #    #    #   ###   # #  # #         # # # ## # ###          #   #       #    #  # #    # #   #                 #   #     # ##  
#  ## ## # ###  #      #  #   #####     #  ##      ## # #     ##   # #     #      ##   #  #  ##  #          # #  # #      ###    #       #     ###   #   ## 
      #### # #    ###  #      #   ##  ##       #   #  ##          #####         # #         # #### #   #  #      #  # #  #  ### ##      #   #  #   #   # #  
   ###   #       #          #          #       #      ## ##  #        #          #  ## #    #   ####   ##          ##  ##    ## # #  ### #    #    #   #    
 #  #  #      #    #        ## #   ### ## #     #  # #  #       ##       ##  # #  # # #     #      # #       #  ## ###  #   #   #  #      ## #  # ##   #### 
  ###    #     #  #  # ##   #    ###  # #   ##   #    ##          # #         #    ## #   #   # # #  # # # #  ## #  ##     #  #  #        #    #   # # ##   
##      ####  #   #   ##   #     #   #     ###    #        #        #   #####   #  ## ## ##  #  # #  # ###  #   # #  #      ###  #### # ## ##   #  ##     # 
 #    #      #             #    #         #    #  #       ##  # #   #  ##    # #  #  #   ## #   ## ###   #        #                    #    ##   #          
#        #  #          ##           ##    #    #       #  #  # #   ##     #  ##        #  ###     #  # #       ##      ###   #       #   #      ####     #  
  #     # #         #  # ##                 # #      # #   #    #      #    ### ##  #      ## #### ##  # #  ###  # # # ## #    #   # #  # #           ## #  
  #   ## ##    #                # ###      # #    ##   ##   ##     #    ##   ### # ##  #  ###    #    #            #  # ##    ####    ###    #        #   ##
    #    ##     #       ##   #  ##  #  #    # ##    # #          #   #    #   # #  #  #   ##  #  #   #   ##       #     ##    #            #  # ##   ##  # #
###   #   #   #   #   ##  # #     #   #    # ##       #    #  # ##   # #                 # #           #####  ## # # #           ## #  #        #### #    # 
    ## # #    # # # ##  #   #     ## # #            #         #          #       #### # #    # # #    # ### ####  #      # # #    #  ###   ##  ##    ## # # 
# # #  #  ###   #    #     #    #   # #       # ###     #  #   #    # #    #   # ###   # #   #      ##     #       #  ## #  # # ###   #     # #     #       
