#  #  #       # #    # ##     #   # ##        #  ####   #  #  ##       # #  # #    #   #        #   #  #     # ## #   # 
 S  #            ##   # #   #   #   # # ### # # ### #    #   # #    #      # #  # ## #     ###  ##  # # # ##   #   ## # 
   #  # #   #     ###      #        #   #         ## ## # #  #     #   ##      #  #  #   #  # #        ## #  #       ## 
  #  # # ## #    #  ###   E  # ##    #     #     ### #  # #  #  ###    ### #    # #    # ##           #  # ## #   ##    
              # #               #         #   ##         ### #     # #    #   #    # #    ### ###   #  # #       # #  # 
   #        #  #     #  #          ##  ##     ### ## #      #          #       #      ##   #     ## ##  # ## ###  #     
 # #  #  #  # #            #   ### #   # #       ###    #  #     # #  # #  # #     #  #    #      #   #  ## # #    #    
##  #       # #    # # ####  ##  #    #    #     #   #  #               #         # # #### # #      #  ## ### # #     # 
#      #       ##    ###    #    ##   ## # #   ## #      #  ##   # ## #   #  # #            ##     #     #      # #  ## 
              #  #    #  ###        ##  # # #     ###     ## #         # #  # #  ## #  #   #  #      # #  ##    #      #
   # # # # ###  #   #      ##  #   ##   #   ##       ##   ##    #   ##  ## ##    # # # #   #    #  ## #   # ###   # ## #
    # # # #   #  #  # #     # # #          #      ###  #          #          ## #  #              #   # #  #    #  ##   
 ##    #  #   #   ##### #     #   ##  # ## o #    #    ##      #     #  #  #      #      # #   #    ##     #  # ####    #
# ###   # #  #    # #      ## #  # # #    # #    ###  ##  # ## #  ## #       # ## # #         #  #          ##  #   ##  
 #    # ##  #   ##  # # #    #      ## # ###   # ## ## ##  #          # ##    # #  #  #     #   #      # #      #   #   
## # #         ## #  ### #  ##    #  ### # # ## ##      # #    #                #  #     # #     ##     ##         #   #
  #   #   #   # #    # #  #  # # # #    ###  #  ##  #  # #    #       # #        # # # #  # ##       #            ##  ##
 # #          # # # #     #       ## # ###  ###  # # #          ##  # #    # #   #  ##   ##  #   # #  #   #####   #  # 
      #         #     #  #          #####  ## #      # #   # ##  ####    #     #  # #  ## ##           #  # # #      # #
#   ##  ##         ## ###    ###   #      #      #### # # ## #  #  #    #     ### #             ###   # ###   #        #
  #  #  # #  # #   ### # # # #  #  ## #    #  #    #    #  #  ## #   #   # ###    #  #  #   # #  #  #      ##   ##   ###
  ###        ##      #       ##  #  ##    #   #  ##    #      # #  #          #   #    #   # ##  #       ### ## ####   #
  ## #  # ##   ##   # #   ###  ##  # #   #  #           #  # #    #     # #  # o #  #      ## #  #      #   #     #     
  # #    # # #    ##  #  #     ### #   #  ##  #   #    ###  #   #     ###   # #      ###   ## #      #    ##  #     ## #
# ##  ###  ##   # #          #       #   ## ##      #  #   # #   #     #     #######  #  #      #  # # #    # #       # 
      ##     ##  #       ## ##   #####  #   #      #  #      #    #  ## ## #  # #            #       # ##  #     ### ###
# #       ## # #   #         #    ##  # ##     ###   # #        #   ##   ##      #         # #     ###     # #    #     
  #  # #      ## # ##  # #     #   #        ###      #   #  #   #           #  # # ## #    #     #     #  ## #     #    
#    #    #  ## ### # ##  ##  ### #   #   ### #   #  ##    #  #  #  # ##         ## # #     # o#     #       #     # ### 
  #       # ##             #     ## #  #   # #  #   # #  # #              # #  # #     #             #       ####  # #  
  ###   # #####  #  ###    # # #        #### #     #   #    #         #   ##  #    # #  ###  ### # ##   # ##  #   ### # 
## ##               # # #     #    #    ## # #  ## ##         #  #  #   # #   #    #    ###  #      # # #  #    # #  #  
#  #          ##  ##      # #        # #  #    #    ###  # #    #    # #  # # ##   ## ###            #  #  #   ##    #  
     #  # ##  #  ##    #  # ###         # ##  ##    # ##    #    #  #    #         ##       #  ##    ##                #
   # #                    #      # ###            #       ###    #    # #     ##           ##   #       #         #  ## 
# ### ### #    #    #      ##    #     #   #  #  ##        #   ## # #      # # #    ##     #    ##  # ##      #    #  ##
#     ## p##  ##  #     # # #    #  ###      ###        ## #   ###     #  ## ## # #     #  #    # #  #  #  ## ##     # # 
  #    # #        # # #  #  # # ##    #    #     ##      #   # # # #  #    #  #  #            # ###    #   # #   #   # #
   ####     ##   ## # # ### ## ###  ##      #    #      ##       #    ##  ###    ###   ##   # ##  #     #           #   
#      #         ##        ##  ###           ## #   ##  ##   ###    # #   #    ##  ## #   #    #  #   #    #  #      #  
      ## # #  #  # #   # #  #  # # #      ##  #   #### ##     #  ##   #  ##  #  # #   ##  # # #  #    #    # ##  #   ## 
#     ##     #   #   ##     #  #    ##        #   #         # ##     # # # # #    #    ## #     ##  ##  ##    ##        
    ####    #   ###    #   # ##      # ## ###     #     #  # #   ###  # ##           # # ## # #  # #         #  # #  # #
#   #             # ##  #  ####    ##    #        #      #    ##  #   #     # # ##  #    ##  # ######## #      #     ###
#                           # #   # #  #  ##  # ###  ##    #  #  ##    #   ###    # #  #      #    ##  #                
   #    # #   ##    ####       #            #    #    ###  # #  #       #    # ### #    # # #  #  # # ##         #      
     #      ## ##     ###  #  #    # ##   #  #      ### # #  #      #  #  #     #  ##           ### # # # #   ## ###  # 
   # #  #   #    #       ###### # #    #     # # #           #    ##  # ###     ##   ## #  #           #   #   #   ###  
 ##        #   ##    #   #  #      #           #   # # # ##  ## #       # ##    #      #  #     #    #  #     #   # # # 
 ## #   #   #  #     # ##   ##  # #       ###  ##          #      #    #       #  ###           ##      ####    #  ## # 
          #      ###  #      #    ###   ##   ##  ####               ##     #  #   #     #      # # ###     #  ### #   ##
  #        #       # # ##      #   #  #     # ##     # #  ##       # ## ####   #  #  # ##   #              #   #   ###  
 #  #     ##  #  #    # #  #     #   #         #   ###     #  # #   ##  # #  #   ##   # # ###  ###  #  #  #     #  #    
 #     #  # #      # # # # ##     #         #    #    #  #    #      #    #    # #   #  ####   #    #    ###            
         # #        ##       ## #         #  #   # #  ## # #   #  #           #      ## # ##    # #  # # ##     ##   # #
  #  #  #  ##  ## ##    ##  #   #    ##            #   ### ##  ###    ####  #     # ## #   #   #       #            #   
    #   # #      #  #    ## #   # #          # ## # #  ## #      #  #     #         # ## # # #    # #  ###  #    #   #  
#   #   #       # ##       #   ##  # #    #       #    ####    #     #  #  # #  # #   # #    ##  #   # #   #     #  #   
 ## #  # # # # #### # #    #                 #        # #  #    ### #    ###  #  # #  #    ###     # #   #          ##  
    #   #         ##    ## ##  ##         ## #   #  ###        #   ##      #     # ##  ###  #### # ## #    #    #  #   #
  #      #  # # #   # #  # #   #    # ###  ####  #      # #  # # #     #    # ##  # #   # #  ##  ##     #  ###  # # ## #
   #  ## #  #    ### #   #          ##  #    # ### #    # # ##                # #  # #    # #  #  #   ##     ### ##  # #
  ###  #  #          ###          # #   ###  #      #   #      #  # #       # #   #   ##   # ## #  ##  #            ##  
      #   #    # ## #   # # #      ##           ## # #    ## #####  #  # # #       #   #         #  #        #   #  # # 
      ##  #  ##       #  #        # # #    #    ##      # ## # #   ### #    #    # #     #   #  #   ## ###   #     ## # 
 # #       ## #  # #  # #  #   # #  #####     ##       ##   #  #  ###  #     #     ##      # ## #                 #   # 
 #   ##      #       #   #  ## #  #    #   #  # #   #  #   #  # #   #       ## ###  ###   # #       ##   ##        #   #
 ##   # #         ##  #    ##  #        # #  #  ###          #   ## #       #   ###  # ## #   # ## # ###    # # ### #   
  #   #           ##          # #     ##     ### #  #  #     #     # #   # #  # #   #       #  ##    #               ## 
     # #     ### # ####  #    ### ##   #   ##      #         # #  #   #  #         ###   #        #    #### ##          
# #     #  ##    #   #  # ##  #     #        #  #     #       #  ###              ## #      # # #    ##  ###     # #### 
 #   ##   ## #  ##       ##### # # #  # #   ###   ###   ####  #     # # # #    #   #   #    ##    # #     ##  #    # #  
  # #  ####          ## ##   ##     ## # ##   #         # # ###          ###      #####   # #          #### #       # # 
#  #        # # #  #   ##      #   #     #   ##    #  #   #           #      #     ###    ## #    #     #   ## #  #     
     # ##   #  #     ##  ##   ###    #                #     # # #   # # #  #    # #   #     ##  #  # # # ##  # #    ## #
 # #     #           #    ## #   # ###  #            # #            #   #  ###       ##    #        #   #  #         ## 
    ####          #              ##         # # #   ## #     # #    ##  ##  ###   #         ## # ##    #         ## ### 
  #    #    #    #    # # # #     #  #    #      # #  #  #  ###  #    #   # ##    #    # ## #   #   #    #   #     ###  
 #            #  #  # ## ##       #            #    ### ###      ##  # #  #  ####   ## ##   # ## ## #  ### ####        #
 #        # # ####    #    # #       ## #           # #          #   ##  #      ##     # ## #      #     ##        #    
  ##  # ##   ##           #  #  ##       #     # #    # #    #   ##  #  ##  # #   #  ## ##    ######  # # #### # #   ## 
##     ##      #  #  ##    #   #  #  #     # # #          #   #  ###  ## #      #   #  # #  ## ##           # ## ### #  
    #    ###  ## ###  ## #      ## #             ##  # ##  #          #    #####  #       #  ##### # #  #    # #   #  ##
  #  # #     #          #      #     ## ###### # #    # ##   #     #  # #  #    ##           ## # #   #  # # #          
    #  #     # #  ## #        # #      ##  # ###   #    # ## # #     ##               ##  #            #  ##### ##    # 
  #  #         #     #  #       # # ##     ## ## #     ##   #   ##          ###      ##  #  #   #  #     #  #  #    #  #
#  ##    #  #             #             # ## #     #        #   #     #  # #  #  #   #      # #  #             ##    ## 
 # # #   ## ##  #  #   ### # #   ## #  ## #         # ##  ### ######   # ##     #  #    #   #      ## # # #  #   #  ## #
    #     ##    #     ##  #       #  #   ##   ### # ###    ### # ###    # #  #           ###          #       #  ##    #
    # #  # # #  ###    ### #   #    #  # #    #   #  # #  #       # # #  # ##     # ##    #         #            #    # 
 ##     #  #      #  #   ####       #     #   #   #       # #       # #      #      #     #      ##   ##    # #    #  ##
 ##   ##  #              #  ####  #  # # ##     # ## # #  ###  # ####   # # # ### ###    ### #       #  # #      #  ### 
  #        #      ### #  # ## #     # #    # #   ## ##    #    # # #     #  # ##      ##    #       ## #  #     #### # #
  #   #  # #       #   #    #     ## # ##      # #   #  ##  ##   #        #  ##      #  #     #    #     #      #       
#   ### #     ## #     # ####   ##                  # # #   #   #  #  ##  # #  #  #     ##     # #      #  #       ##   
   ##   #### #  #  #     # #      # ## #   #  #  ### #   ##   #####  #    # #   ##   #    #   ## ###  # ## ##      #  # 
    # # #       # ## ######     # #  ######   #     # # #       ## #       ######     # #       #               #       
      #  ##  #    ##   # ##  # ##    #  ## #       #    ### #       # #     #  # ##              ##      ###      #     
  #  # ###  ## #    ### #       #     #      ##     #  #         ##     #  ## #  #     #   #   #  #             ####    
 #  #      #### #   # ##  #   ##   ##      ## #  #             ##       ##  ##  #    #   # #    #   #   ##    ## #   # #
  # # #     #      #   # #     ###        # # ## ##   #   #### #   #  # #  # #    ## ##  ##    #   #           ##   ##  
 #        ##  #   #   #      # #   #  ##    ## #           #     #  #      #   #  #   #     #    ####   ### ##          
 #  # # # ## ##      #  # ##     #  #    #    # ## #            #    #   # ##     #   #          #  #      #     #   ## 
     #  #      #    #        #    #   # #  ##   #                ###     ##     #   #    # #     # ##  # ##   #  ##  #  
 # #    ### #     ## #  # # ## ## ##        #  # # #    ##   #   # # ###    ##        #    ### # #   ##   #    ###      
#            #  # # # ###    #         # # #     #  #  #        #   #   ##    #             #   #  #   ## #   #      #  
 ### #         #  #     # #   #  #      #  ##    ###     # # ###     #     ##   #       ##       #        ###   ##  #  #
### ###  #  ##   #  ##    #    ##   # ####      #   ## # #  #  ###  # ####   # #     #     #     # ###    #   #         
 #  #         #         # ##  #   #    #   #  ##       ###      #### ##     #   # # #  #   #   #### ## # ##  ##   ##   #
       #   #      # ### #   ##  #   # # ##  ## ### ##           ### ###   #  #     #        # ###     #    #    #   #   
   ##    #       ##         #  ##   # #  # #    # ##        #   #  #     #  #  #      ## #  #         #       #  ##   ##
   #  #    ##       ##  #  #  #      ### # # # #        # #    #   ##   ##          #  ######            ## ## ##    #  
#   ##       # #        #    #    #    #           # #     ## #   ### #         # #  #    #  #  #  #    ###    #    #   
          #    ## ## ### #   #       # #  #  #   ####  #     #   ##    # #   #       ## # #             # # #   # ## #  
   #      ####  # ##      # ###     #   ##   #   # #  # #  ##       # #  ###     # #       # # #   ###  ## # #    #     
       #  ##          ##    #       #  ##    #     # #    ##  #  #       # # #   # #  ## ##      # # # ##  ##    #  ##  
  #   ##  #   # #      ##         ##  #      ###  ##       ##   ###        # #   ## ##     #  #   ###     #    #      ##
# #     ##        ####       ##  ###   #   # #     #        #  ##   ## #      ## #   #    ###       #   #   # #  # ##  #
#    #   #        ##   #     #  #  ## #   ##  # ## # #    #  #             #    # ##     ##   #   # ##    #     # #  #  
 #   ## ##  #  ## # #  #   #### ##     ## #   # #   #     # # #### #   ##        ### #       ###  ##  # ## ##        ## 
     # ##      #      # # # #    #                # #  ## ##  ##    #  ##             #### #   # ##     #    #      #   
###      # #    # #    #  #    #    ##         #     # # ##    ### ## #  #   #  ## #   ## ###         #      ##  #  #   
#   ##     #     #  #       ##### # ## #   ##                ####     #   ## ## # #   #   #        #    #  ### ## # #   
  #      #    #           #  #       #   ## #  ## ## ##                #     ###  # #  #   #       # #  #      # ## # ##
## #  #     #   #    #        #   ## #   #      #  ##          ####  ##    ## #  # ## # ### ## #  ####    #    #  ##  # 
    ##    #   # # ##    #      ### ##  ### #     #   ##  # ##   ###   #  ##        #  #   #  #   #          ##      #   
##   #       # #  # # #         ## #  # #             ##     # #  ## # ##  #   #   #    ##        ### ##  ##    # #  ## 
  #  #   ### # # ## ##  ##   # ##   #         #         ###   ##  ## ##     #  ## #   #     ##    #   #      #### #  #  
 ### #   ####    ##     ##    ##  #    ##         ##    ## #  # # #   ##   #    #### # #  ##  #             #        ## 
  #  #####  #    #        #  ###  #  #   ##  #    # # ###   #   #             #   # #    ###    ##              # #     
    # #          #           #  # #  ##       #         #  #   #       ##   #  #       #  #    ## #  #   #  ##  #   #   
    #   #    #             #        #         #         #  #   # # #        ### ##    ##     ###       ##    #  # # #   
  #        ##    #        ##     #  #   #                #  #   #      #    # # #             #   #  # # # ##  ###     #
#   #        # ##   # #     ##   #     # ###   # ###    #     # #  # ##               #       #         # ##   #  # ### 
#      ### # #  #   #  ##   #    ###    ####  # #    #   # #   ##   #    # #    ###            #     # ##  #            
   # # ## # ###  # #     #  # ###              #  ###     #  #     # ##   #       ####  # #  # ## ##         # #   # #  
 #  #           ##  #   # ## ##    #  ## #  #      #   #    ## #        # #    #  ##   # #   ####    ###    ##     ###  
