  #   ## #     #    ## ### # #   ##        # #        ##  # # #     ##  ## #       #      ##      ##  #               # #    # #   #  # #           # ##           #  #     #  # #   # # # # #   ## 
 S ### ## #    ## # # #    #    # #     ## #    ###      ##       #  #       #            #  ### ##             # #  #     ## # #      ##      #    ## #  # # # #          #        ## #     #  # ##
 #         #    #     #  ### ###  ## #    # #   #    ## #    #    ###    ## # #  ##     # #  # ## #  #  ###       #  ##   ##      #  # #      #   #          # # #   #  # #  #    #  ##  #  #  #   #
## # #    #  ### ##        ## #  #   #         #             #       #     #  #    #              # # #          # ###   # ##   #   #  #  ### ## #      #   #      # #    #  # ####  #  # #         
 #  #    ###    #      #      ##            ##         #     #  #    #     #      ##   ###  #      # ##   #     ### ##      #  # ###   # ##     ##  #   ##     #  ##              # #    #   #  ##  
         ###   ###  ##   ##  #     # ##     #   ## #   ## # #  #          # #  ##  #      ##                          ##   # # ##   ###  ##     # #    ##             # #        #  #     ##    #   
     # ##  #  #   #           #   ##       ##  #   # #   ##  ##      # ## # #  #        # ##     #        #   #      #       #    #  #           ##   #            # # # ##         #  #    ##   #  
# #  ##   #  #  #    #         # #        #    #     ##  #   # #   #   #      #   #  #       ##   # ###   ###   #                   #   ##       #   ##  #   ##  # #  ##  #    ## ##### #    #    # 
#   # # # # # #        ##        #  # ###      #    ##    #       #   #       ###     # #######   # #  #            ##     ##  ###  ### #     #   #     #  # ##         ###     # #   #### #  # #   
          # #         #   #  #  #   ##        #    ##   #          # ##      #    #  #  #      ###  # # #   #  #   # ### #       ## #     ##     #  #     # #          ##    ##   #   #  #   #    ##
# # #     #   #  #    ### # #         #  #  #       #   #        #  ## ## #     #     #  #  #  #    #  # #    #     ##  #   #        # #  #  #     #    ### #       #  # #  #  #   # # ### # #    # 
##  # ##  #    # # ##       #    #   ##     # ##     #   #  #  #       ###  ## #     # #   ####      ## ##  # ##     #####      # # ##       ### #    #  # ## #  #  #   #  #    #  #    ## #   #  # 
   ##        ## #        #   ###       # #####     ##   ####    #  # # ###  ## ##  #  ###       #          # # ### ##  #    ##  #  ###       # # # # #    #      #               ####           # # 
 #  #  #   # #    #     # ###       # # #   #     # ###   # # #  # ## ##  #  #  #   #          ### #  #  #     #   #        # ## #   #  ## #  # ##        #   #    ##  ## #   #   #  # #  #   ## ###
# # ## ##  ###  # ##   #  #   #   # #  ##       #  #   # # #  #   #### # #        #  ####  ###  ##   # #     ##   #   ##     #     ## ##   ##      ##   ##      ### #  #  # #    ##  #    ###   #   
  # # #       #  # ####   ##   ###     # ## #####        #   #   #   #        #   #       #      ##   #       #  #    ######  # #     #  #  # # ##   ##  # # #####       ## #    #  #    ## ##  # # 
        ##  #       # #       #    #   # #  #####     #  #     #        #  #       #      ##      ##   # #  ## # ##   ## #    # # #   ##    #  #      ## #   #   #         ##       #     #   #   # 
  #    ##   ##  # ## ##    ## ##    # ##   # # # ###   #         #     #  #####     # #      #      #     #    #         ### #  #   #  # #   #    ###  #  #    # ## ### ##   ##    #  ###           
  ### ##  #   ##  # #   ##          ### #         #      ##   ##           #     #      # ##   #  #  #     #  #     ## ##  ##   ##  #   ## #    ###      #    #  ### ##            #       # #   ###
#  #           #   #   #     #   ##    ## ##  # #  # ## #  #  #          ###   # # #      # #        # #         # # #    # ###        # # ## # #            #      # # #  ###  ##  # #          # #
   ###  #       #  ### # # #    #     #      # ## #   ##  #     # #  ##     ##### #    ##    #   #   ##  #    ###     ### # #  #     # #       #  #####           ##    #  #      # #  #    ###     
        # #     # ##        # #      #            ###  #  ### ## # ##  #              # #         #      # ###  ## #   #   #             # ## ##  #   #  #      #        #    # ## #    #         ##
# #           # #    ##  #  #  ##   #    ##   #   # ##     #   ##  #    #   #  ## #  #   ####### # ##            #  ## #   ###    # #   # #  ### #   ##     ##   #      ##    # #  #    # ##   # # #
  #   # ###          ##### # ## ## ##  #    #     # #  ### # # # #  ##     #  #  #           #  #      # ### #     #     ###  #    # # # # #  #  #      # #  ##     #  ## #  #         # #   ###  # 
     # #     ##   #     #   #        # ## #     #  # ##     #          # # # # #   #   ##         # #     ## # #  #  ##              # #   #       #    # ##   #   # ## ###  ###   ##  #    #   ### 
      #         ####   ## #  #    ## # #        #     #       #  # #      ##  # ####    ### ####   #   # #            #  # #    #  #       #     #    ###   #     # #  # ###            ##       #  
   ###    # # # #  ### # #    #    #       # #        # #       #   #   #  ####    #  # ##     #     ####  ##  ## #   #  # # ##  #   ###  #  # #   #    ## ### #    #  ####      #   ####   #  ##   
##    #          # ## #    #       ### #        ## ## # #      # ## #     # #        #  #     #  #   #     #   # ####     #        ##      # #    #    # ###       #   #   #  #       #  #   #      
### #          #     ##     #   #     #   #     ##  #             #    #       #   ##  #  ##        ##        #   # ##  # #      #      ##  #    #     # ###    ##   ### # #   #  # # #  ##  ##     
#   ##   #    ## ##  # ##  #   # #    #    ## ##  ##    ### ##  ## #  ####   # #     ####  #####   #       ##             # ## #  #     #    # ###  #     #  # #  #  #  ##  # #          ###  ##    
# #     # #  ## ###  ##  #       ###     #        #     #       # #  ###   #    #   # #  # # #   # # # # #     ### #            ##   #  #  #  ## ##  # #  ##  # #  # #  # ##     # ##    ## #    #  
   #      #  #  #   #     #   #### #   #  #  # # # # #     #    #   ###     # #      #   ##  ###  # # ####      ###    #          ##   #    ##  #    #         # ##  # #    ##        ##       #### 
          #       #      ###     #  ##  ##  #     #     #   #              ##  # #  #    #       # ##  ##     ## ####         ## ###   #   ### #  #          ## #     #   #  ###    # # # #  ##   ##
  #   #  # # ###  # #####  #     # ##  # ##  # #  ###    # #   ###        ##            ###    #     ##  #  #          #  # ##     #   #    #    #  #  #   # # #  ##    ##    #      ##  # # #     #
#         #     #      #  ### #   #  ## #    ####         ## # #   ##         #  # #  #  ##  #         #     #  ##      #      # ###  # #     #  # ##   ###       #   ##    ###  #   #   #         #
   #          ##            #  # ## ##   ##      ###  # #    ### #  #    #  ##      #   #      #   ##      ##   #   ###    ### #      # #    #           #        ## #    #       ##   #      #  #  
 ## ## # ###             #   # # # # ##          #  #    # ###   #         # #  #    # #  #      # #         #  #    ##          ## #  # #   #  #        ## ##  #        ##  #    #  #      ##  # # 
     # #       ###  #   # #   #   # ###         #      # #        #      # #    #      #  ##  ##    # #        #       # # ## ####   #  ####      #   # #   # #  #   #  #  #      #   ######        
    # #             #  # #   #   ##  # ## #  #   #  # # # ###    #   ##    #   ######          #    # #     #     # ##  #  # #    #      #  ##      # ###    #   ##   ##  ## ####            #  #   
  #   #  #   # ##    # ## #   #####            #       #  #        #     #   ##    # ##   #       #    # # #     ### # #### ##  ##   #    #     #          # ##  #  #      # #   ####       # # #   
 ####      #     # #   #     ##    #   ##   ##   #  ##   ## # ##      #  #    #  ##   ##              #    #   # #  #      # # ## # # # ## ## #     ##       ## #  #       #       #        #       
#     #  ### #  #   ###      # #    #  #    #            ###  #  #   #    #   #   #  #    #      ##  #   #    ##      #    #    # ###  # #   #    #   ##   #  # #  # # #    ##  # ## #     ### #   #
   #      #         ##       # #   ##  #   ###  # #       #        #    ###    #      #  # #  #   #  ##    #  # #   # #    ##   #  #   #    ##   # #####          #      #     ## ##  #  ##   # #   
#   #  ##     #    #         # #         ##  ##   # #  #    #   #    # #  #           #          #          # # #  ##     #          #  # #  #    # ##  #         # #  #   ##       #       # # #   
 ##    #  #        #     #        #    # ## #      #   #   ##       #      ## ####  #  #          # #    ## #   # # ## ###     #     # # #       #   # #   # #  #   ## #  #   ###   #  # #     #    
     #   # # #    # # #   # #  ## #            ##  ##      #     # #      ##      #    #    ##  ##  ##     #   #    #      #### # # #   ## #         ##       # # #       ##  ###  # ## #    ##     
        #   #  # #   #  # #    #    ######       #     # ##     ##           #     #  #      #    # #      #                #     #####  # ## #    #      #             ###    ##                  #
###   # #   #     #    #  ## ##    #   #   ##      # ##     #  # #            #  #   #  #  #  #     #  #    #  #    #     #     #  ## # #   #  #     ##  ###  ##  #  #            #     #   #       
 #   #### # ##        # ##        #        ## ###  #    #       ##           #    # # ##                        #  #  # # # #        #     #   ###     # #    # ###      ##   #      # #      #  ## 
       #              #         ##    ## # ##     ##  #   # ##  #  # ## ###    #  #          #   #    ##  #     ##    #       ##   ## #  #   #    #         #     # # #  ##       # #   #    # ##  #
 #  # ## ###  #  #  ## #### #  ##  ###  #  #  ### # ##   ###   ####     ##    ##   # #   # #    # #  #   #  #  #         ##    #     #     ####      #  #   #  ## #             ##  # # # #   ##    
#  #    ###  # #  ##           #     #   #  # #  #    #      #    #  ####    #    #    ###  ####  ## # #   #      ##       # #  #       # # #  ##  #         ####             # # #      #  # #     
 ## #  ##    #  #   ##  ## ####      ## ###     #  ###    ##     # #  ### # #  ## ### ## ##    #   #  #      ##             ###    #  ##    # #      #  #       #  # #    #  ###         ###        
 # ## # # #   ## #    # #### ##    # ##     ####   ## #    # #       #            #       ##  ###### ##  #           ##         ### #  ##  #  ##   ## #    #    ##  #    # ##           #   # # ##  
    #  # # ### # #  #    #   #  ##       #  #   #    #  ##  #      # #  ### ## #       ##  # #  # ## # # #      #  ### #           # # # ## ##  #   # ## #  #  # ##     # #   #             ##   ###
             ##    # # ###      ##  #   #  #             ##  #   ###   ##         ## #   ##    ###       #       # #       #  #   # ## #  # #    # #   ###  #    # #   # ## ##   #  # # #   ##  # # 
#       ####    ###    ##   #   # # ###  # #      ###   ##     #  #    ##    #   ##     #  # #            ###     # #  ### ##              ##    # # #    #    ## #     # #  #     ##  ####  # #   #
  #   #   ##### #  # ##  #  # #   ##   #  # # #     #       ##           # #  ### # ####     #      #  #  # #         #  #      #  #     #  #    ## #     #       #  ## #      ##     ##   #  #    #
  ###  #  #     # #          #         ######  #  ##        #  ## ##    ##     ## # ## ##    #  #      # #  ##     #   #          #    #       # #    #    #   # # # #  #      #     # #      #   # 
    # #     #   #  ##   ### # #  # ## #####  #  #  #  # #      ######   # #  #  ##  #    ###   ##                  #  #  ##   #    #     #                  ####     ### #     # ##   #  E####  ##  
     # #   ##### #  #  #     #       #      ## # #   #    #   # ##   #        #    #    #   # #     ##   #     # # # ##  #  #       #  # #   # # ### ####  # ##     # #     ## # #  # #  ##  #      
    #  ###      # #   ## ## ##      #         #    #     ###        #           # #     #    #    #     ##  ##   #### ##       #     ##### ##  #  # ##            #  #    #### ## #  ##    ## # # # 
 #  #  # ##    #     # ##     # #  # ##   #       # #  ###      #     #           #  #  #   # #      ##    ##    #  # #     # #           ## #   #  #     ## # ## #  # #     #       ## #   #     ##
     # #         ###   # # #      ## # #  # #  # #     # ###   #   #  #   ## #       # #         #       ## #  # #  #     ##  #   ## ## #     #   #        #   #      ##   #   # # #   #    # ###   
# # ###      #     # # #   ###       #    #   #  # # #  #  #         #    #     # # #    ###      #         ##  ### ##   #          #    ##      # #     ##      ##  #    # #      #        #  # ## 
    #   #       # ####   ### #       #  #####                            #   # #     #      #          #  ##  #     #        # #  ##  #  #   ##     #           # ## ## #   #   #    #### #     ### 
#   # #    #   #   # ##  ##  #      #   # ###   ##    #  ##  #    #  #  ## ##  ###     # # #  # ##### #       # #     # #  #  #  # #    ##   # #  # # ##  #    #   #  #   # # # ### # #   # #     # 
    ##   #   # #    #        ### #  #   #   ##   # ##     # ## ### ##  # ### # # # #        ##  #     # #    #  #      #   ###  #  ## # ##    ### ##### # #   #  #   #   #  ##   # #       ###  #   
  ##       #   #    ##          #     # ##    #  #    ###  # #    #   ## ##   ##    # ##        # # ###   ####     # ##  # #      #     # ### # ##         #  #          #  #  #     #    # ##    # 
## ##  # # # # ## # #     ##  # # #   # # ##  ##     ##    #    ##      ###     #    ## # #   #   #   #  #  #  # # # #        ## #  # ##    #  # # ##  # #  # # ##    ####      # #     #       # # 
 ##  ## #  ## #     #    #    ##    # #          #      ### #  #        ##     # #       #  ##   # ###    #        ###    #  #       ##   # #         ####    ##     #     ## ##          ##   #    
               #     # #    #     #  ##         ##  #      ## # #           ###  #     #     #     #  #  ##       # #     #    ###    ##   #     #     #  #               #     ## # ##    #      # 
# # # ##   #####               #     ## ##     ###  #    #        ##  ### ## #  #  ##   #   # ##        # ###  ###     ##  #     ##  # ###   #      #       #  #    # ###      # #            #     
  #     ##      #    ##  #  #      # #   #     # ##    #       # ### ###     #  # # # #     ### #   # # #     # ##   #  #      # #    ##    #           ## #     # ### # # #      #### ##   #  #    
   #    #  #   #      ##              ##      #  # ##  #  #       ##         #   # ##  # #     ##      #       ##    #   #    # #      # #      #    #         ####     # #          ####           
#          # #  #  ###  ###     ##   #       ##        ##  #  ### ## ##       ##  ## # #     ##     #  ## #  # # ##  #   ##          ### #     ###   ### #        #         #   # #####   ## #      
 ##   #  # #       #  ## #    ## ##  #      # #  #  #   # #   #  # ##    #   #    ###  #   # ##   #    #####  #   ##   #       #   # ###       #   # # # #         # ##   ##       ##       ## ##  #
  #          #     #      #      ###    #        ##        #     ##   # ###            ## # #        #   ### #     # #   #  #   ##    #          # # ##  # ### #   # #  ##   # ###         # #   ###
 #  # #     #     #    #  #      ## #    ##       #    ##  # #         #   # #      #   ## ###  #  #    # #   # #    # #    #      ##    # # #     # #  # # #  ##   # #   ### ## #  # #  #  ##   #  
 #       # ## #    ## #  ##     #  #  #   #     # #   #     #  # #     #         ### #                #     #  ###  #   #   #    ### ##    #        ######  #     #           #  # ##  #        ##  
## ##     #   ### ### #  # # #          ##      # # ##  # ##  ###          #  #       #  # #   #                # # #     #  #   #    #    ##  ##  #   #  ##     ## ##   ##   #   ## ## # #     #  #
        #         ### # ##   #   #    # # ##    #   ##       #  #       # #     #  #       #  #     # ##  # # #  ##  ##    #          #     ## ## #          #   # # #   #   #    #   #   ## # #  # 
######      #    # #  ## #     ## # # #  #  #  ##  # #    #  #  ###    # ### #  ##       #            # ## ### #   #  #   ###  # #####   #        #     #    # # #    # ##    # ## # #   ## #   #   
   ###  #   # #     #### #  #  ##         #     # ##      #  ##         #   # #       # #  # #            # # ###   ##  #     #  # ## # #     #    # ##    #  #  # #            #  # ##    #        
# ##  # #    # #  #   #        #   # ######     ## #  #   # #    ####  ##        # # # #  #  #      ##        ## #    #   # # #  ##   #   #      #  #     ##  #   #  #  # #   # # ## #       ##  ## 
  #  ## #   ##    #        # #  #  ##         ##  #     #   ## #       ## # ##  ### # # # # #  # ### ## #     # ##  #       #  #   ##  ##   #  #      #        #        ## ###           #  #       
   #                  # #      ####  # # # ##   ##    #       ##   #   # #    ##   #  #  ## # #             # # #      ##      ###  # ##    ##     #         #  ##     #    #    #  #  ##  # #  # # 
        #    #    ##    # ### # #  # #     # ##    ##  #  #    ##   #     #   ####          ##       #    ##    ## ##  #  #   ##       #    ####   ##  #         #      #       #    #   #       # #
   #      #     # # # #  # #   ##   #      #   #  #  ##    #    # # #       #   ####   ##    # #    #       #       ##      # #  #   #    #      #   # #   #  ##  ### #    ##   #      # ## #  ###  
##    #     #  # # # # #  # ##  # #        #     ## ##    #  #       ####   ##  #    ## #      ###         #          ###  ##  #           #     # #    # # #   #     ##            # #   #  #    # 
 # #       ### #      ###          #      ##           ## #   #    ##  # #         #  ##    # #   #    ####  #    ##   #  ## #       # ## #  #   #    # #      ##   ## #  # ##          # #  #   # #
         #  #  ## #     #  # # #           # #      #  # #  #####  #  #       ##              # #  # ##     #      ##   #  # # ## #  #  ##  ##         #    ##     #           # # ## #    #        
#           #  #  #    #   ##  #  # ##                 ##   #             #   # #### #  ###  ###        #       # ##     #           #         # #   ##     ##  #      # # ####   # ##      ##    # 
              #   # ##     # #### ##   #    # #  #     # #   #    #     ##### # ##  # ##       #  ##      #    #     # #     #   #  #   #  ##     #   ##     # ##    # #      ##      ##  #   #     
   #       #       # ##     #  # ##   #   #     #   # #     # #   # #    #  ##   #    #      # #                    #       #       ###   #     ##      ## #      #    ###     #    # # # #         
  ##      ###       #  #  #   ##  #  #  # # #     #             #          # #   #  # # #     #        # #    #  #  ##        ##       # # # #   #  # ##  # # #      #      ###            #  #     
    #    #          #      # ## #     #### # # # # #      ## #           ## # # #  #   ##       ##  ###  # ##             #  #      ##      #  #    #   # # # #  #    # ##      #   #    # #       #
##  #     #   ## #    #   ##    # # #          #     # # ## #  #  #     #   # #  # ## #   ## #   ##    # # ##     # # #     ##   #    # # #       #     ### # #    ##    #               #    ##### 
 #   #   ##  ##        #    ##  #   #    # #      # #   #   #    # # # #    #   # #  #     #     #    ## #  #  # #        #    ####  #      # #   ##  #   # #         #  ## ##  # #  ##   ##  #     
####    ##      #   #  ##      #           #     #  #   ##   #          #   ## ##  #       # #  #  ## # #  #     ###      #  #  #    #     ##      #  #   #   # ## #  ## #       # ### #        #   
### #     ##   # # #  #    #     # #  ## ###    ###                #   # #        #     #   ### #  # ### # #    # ## #      #    #  # # #        #  ##       #  #     #          #  #  ###          
    ##   ##     #  ###  ##  #  #    # ####   #   ###  #  #   # ##    #    #### #       # ## # #   ##  # # # #         ## # ##   #     ##  ###  #  #   #   ##     ##### #          ###        ##   # 
   # ##     #  #      # # #   # # ###        #  #    #  #  #   #   ## #  #     #    #       ########  # #    #  ##      #   ##     #         #  #   # #      ##      #    ##       # ##  # # ###  # 
  #     #         # ###    ##       ## # # #                             #      ##  #      #  #   ###   # #      ### ###        #    # ## ##   # #  #   # #    #  #  ## ##          ##    #    ###  
