         ### ##     #     #  #   # # ##  #  ##  # ###    ## # #       ###     #    # ##    #  #   #    # #   #   ##   # #  ## # #      #  #        #   ##        #       # #       # #  ###  
 S           #       ###     #   ####  ## #      #   # #    #  ##        #     #  ## #       #    # ##  #    # #      # ##   #    #    ##   #   #   #  #     ##   #     #         ## ## #    
 #    #  #      #   # #        #  #        ##       #    #     #               #   ###    #  # ###  # ## #   #  # #   ###      ##  #     #       # # ##   ##  #    # #        #         ##  #
## #  ###      #    # ###   #       #     #  #   #         # ##       # #      ##  #     #   ##   #      #         #  #  #    #                  #  ##  # #  ### ##   #   #         #   # #  
     #      #      ## #  #          #     #  #           #    #  #    #    #   # #  # #     #         # ### # #   ##    ## #  #  ## # # # #   #  # # #  ##  #   #     #      ##  #  #  #  #  
### #  # # #   #  #   # #  #        # #    #     #  #       #       ####  #  #           #              # # ###   #  # ##    # #     #####         # ##    ###### # ##      ##     ## #  #   
 # # #           #    ## ## # #     ##  #   # #  #  #         #   ## #  ##      #   ## ## #  #  # # ## ##  # # #      # #      #   #    ## #  #   ##      #  #   #   #    #      #  #### #   
    #       #  ##   # #  #      #      ##      #   ## #    ###   ## #     ##  ##   #  # ##    #   # #####    #  # ##   #       #          #     #  #           ##   #  #   ##      ###  #    
  #   # ##     #####     #         ##    ## ## #      # # #      #  ## ## ##    # #     # #         ##   #       ## ## # #  # #  #      #   # #       # #      ##      ## #    # ##    #     
      #  ##      #      #         #   #     # #  ## ##  #    ## # #   #  #  #           ## #  ## # ##      # ##      ##    ## #     # #     ##  ## #   ## #     ##### ##       # #         # 
    #   ##     #   #   ## #####    #   ## #  # #    #    #      #   #     ##          #         ## # #   #           ### #             #      #     ##  #### # #    #   #### # #    #        
        #  # ##        #  #     # #       #    #   #           #   #   #   #       # #   #  ##  #      # #  #  #     #    #  ###    ##  ###   #  #   # # #   #  ###    ### #####     #    ## 
##      ##           ## #  ###  ##    ####  #  ##    # ##  # #          ## #        ##  #  ##     ##     #   ## #          # #        # #  #  # #     # #         ##  #   #             ##   
##   ## ###         # #  # #   ##  # ###  #  ## #     ##   #      ##         #       ##      #  # #   #   # #   #      # #         # # ##    #   ### #   #   #  #    # ## # # #       #      
  ##  #   #  ##   ###    ### # ##  ##  # ## #   # #        #  #   #  #  ## #             ## ##  ###          ## ##  # #   #   ###    #    #   # # #   # ##  #  ##   #      #  # ##   #     # 
   #  # ##   #  # # # ####    # #        #  ### #   #    #            ##      ### ##  ## #####  ###     #  #    #  ###      #    # ###      ###  ##    #  #      #  #      # ##       ##  ###
# #            # #     #  # ##  #     ###         ###   #   ## #    #  ##    #     ##  ##   #   # ### #  #  #  ##     ##     #     # ## #  # #        #      ##   ## #  ## #  ## #    ###    
 #  # #     #   ##         #   #   ##  ##### # # ##    #  #     #   ###### #   ##   #   #  ##   ##        #         #       #   ## #     # #          #        # #        #### ##   #    ##  
#    # #  #  #  ##        ## #     ## ## #     ## #  #  # # #     #  ##  #   # ## ##    #   #     #  #   ##         #             ##  ##     ### ## #  #    #       # ### #  ##       #    # 
  ## ##          ####  # #        ## #  ##   # #         # # #          # #      #    ##  # #   ##     #     ##    ###   #   # ##  #   ### #         ##      ##  # #         #      #  # # # 
        #  #  #  ## # #    ### #  ##    #                 #  #  # ##     #  ####    ## #  ##   #####   #### #  ## ## # #  #   #   ###     #  ### ##   #                      #     #   #   ##
   ## ##     ###     # #    #  #     ##  ##    #     ###  #  ##    # #####  #  ##      # #### ##   #   # # # #   ##  #      #  ####       #                ##        #        #      ### #   
 ## # # ## ##  ## # # #       #      #   # ##    #  #  #  #  #       # # #   # #  #     ### #    #   ###    #  #     # #   #    # ##     ## # #    #  #    #     #  ##        #       #  ##  
   #   #       #    # #    #   # #   ## #  ##        ## #####    ### # #     ##     #        # #     #  # # # #  #   #           #     # #   ##   # #   #      #    #    # #            #    
 #            #   # ##    ###     ##   #            #       ### # # #  #    ##     ##    # # #           ## #   #        # ## ###   #   #       ### #    # #     #  ###        #     # #     
   ##  # #####    # #   #  #    #  #   # #  ###   #  ####      #  #   # ## # #### #  #   #    ##    # #  # #  #    # ###      ##   #     #      #      ##     #  #  # #  ##   #              
     ##  #  # ###       #   #### # # #       #     # ## #        # #    #           #       #  #     # # #  # #  # #   ##    ##        #    ##  #  # ## #   ##  ####  ##  #  ## ##  # # #    
 #  #    #    #               #     #  ### #  ##   #       #    #   ##    # #    ##  #   # #  #  #        #          # ##   ## #    ##       ##   #  # #        # #    # ### ######    ##    
 ###  #  #         ##    #     # #  #  #    # #  # # ###  # ##   ##     #    ## # ###  # #    #      #   ## #  ## # # #  #  # #    #     #  ##     #        #    ##  #### #   ## # #    ##   
  #  ##  #      # ### #     ##     #        #  #  #     ## # ##     #  #        ##     ###        #       #          # #  #    ##  ##   #          # #  #  # ## #  #       #     ##          
#  #  #  ### #     #      ##    #    ## # #     #   ##   #  #       ###  # #  #  ##  ##  # #   ##    #  #   ##    #          ### ##   # ## ## ## #  # #   #    # ## #    #    #   # ##   #   
   # #     ####          # #       ## #   #         #           # ###   #      # ##  # ## ### ## # #  #   # ##  ## #          ####      #           #     #  #      #  #    #   #           #
   #  #       #  ##    #  #   # ##      #   #  #    ## # #       # #       # ##   #   ###        #     #     #  #      ###  #          #     ##     #           # #  ##  # #   #     # ### # 
##     # # #####    #        # # #                 #   #    #    #  #      ###  ##           ##         # ##   ##    #        #     #  #  #    ##  #   #         ###    #       # ##  ##    #
   ##  #  # #  #      # #  ##  # # #    #   # ##   #  # #    #    #  # # # ## ## #   # E  ##   #### # #   # ##        #  ### ###   #      # ##  #    #          ## # #   ##  #     #         
   # #    # #     ##   ### #     #    # ##   #    ##       ### # #           #       ##  ##       ##  #   #      # ####    #          #      # #    #   #     ###     #        ## #    ##  ##
#   # # #          #      ##      #  #   ## # #   #     # # ###   ##   ###     #        #     # #     # ###  #   ## #    # #      # #   #    #   #   # ###        ##  ##   #     ##  # #   # 
