  #  # #   ### #     # #  #   ##   ## #   #    ## # # #  ##     #  #   # #    ## ###      #   #    #  # # ## #  # #                  ##      # #     #   #  #  # #
 S  #  # ##      ### ######    ##   ##  # # #   # #   #    #  #    # #              ####   #####    #    #      #       #       #  ## ##  ### # ####    #      # #
    #          #      #  #       ##   #  # #    # # ## ##     #     ##   #  ##     ##         #  ####     # ##   #                ##    ## ## #  #   #    #       
  ##   ##     # #  #   #    #   ###    ## #   #    #       #         # #    # #  #      #    # ## #     ## # #  #  #     ### ##            #  #     #   ###  ##  #
      #### # #  #     #             #  #    #   ##     # ## # # # #  #   # ####             #   # #  # # # ##   #   #         #    ###      #   #   ###    # #    
 #       #  # ##       #        #   # # ## #          ## ## #  #   ## #   #       ##    #   ## # ##   #    ### ##          #  ####  #   #     ## # # #  ####      
    ### #  ###    #  #          # #   #     ##       ###       #  ##    #  #   # # #      ##  #                     #    #  ##      ### # ##  #   ##      #       
# #####    #  ## #    ###      #  #       ##  # #### ##   # ## #  ## #  # #    #      #  #  # ###   # #   #  # # #  ##  #  #   ##   #    # #      ###  # #     #  
 ##  #       #         # # ## #               #     #              #   #   ##      #    # ##      ## #  #      ## #  #  ##         # #  #   #  #      # ## ##     
 #  #### #  #    ## #     #  #  # #     ### #    ##  #        #   #   ## # #   #       # ##     #  ##    #   #  # # #  ## #    # #   # #   ##   ### #   # ##  ### 
            # #   # #  ## # ##  #          ##        ##     ##   #     #  #       ###  ## # #  #   #  # # ##  #   ##   ## #   # #     #     #    # #   # #     #  
  #   ##  #    ##    # ## ## #     r  ###    ####  #   # #  ## ##   # ##   # #    ##   #       #   #  ##   # #  #  ##  # # ##    # ####   # #   ## #  # ## #      
 # ## # # ##  #       #    #  #   # #       #  ### ##        # ##      ##     ###    ###   #             # # #  #    ##   # ##  #         #   #    ##       ###  #
  # # #   #### #  #  #  ##       # ##     #           #   #         #   # ##      # #    #   #     #  #        ###      #       #### ##     #     #    ### #      
   # ##  #  # ##    #   #  ## #       ##    #          #          ## #   # #  #  # ##     ###  #    ## #    #     # ###   #        ###  #  #     #  #  ## #     # 
 ###    # # # ### #  ##     #   # ##       #  #    #    #     ##   ## #       # #  ## ##  ###   # #        ###    #         #   # ### ##          #        #    # 
#       #  # #       #      ##  #    #  #   ###        ###  #     #   #        #  # ###  #  #    #        #    #  # #   #   ## #      ##      #  # #  #  #        
# ###    #  ##    ##    #  #      # # #  ##   #      ###      ## #     ### #    # #  ####   #    #  ###  # ### #####  #   #   #     # #   ####        #  #  #    #
#           #    ####      ## #  # #    ##   # # #   ##   #  #       #      # # ###  #      # # ####        # #    # #    # ## ##       # ####      #    ## #  #  
## #     ###           #  #    # #    # #   # # # ### #       #    # #      ###   # #         # ##      ## # ##      #         ##  #     # # ##          #     #  
   # ##  ##        E         #  # #  ##     # #        ##  # #    ##  # # #  #       #    ##   # #    #    ##  # #### #  #    #  #     #  #  #     #   #      #  #
     ## ##       ###     #    # ###        #  #                  ##       ##        #  ####  #  # ### #  # ##     ##       ## # #      #     #   #              # 
#  #  ## #    ###  #  ### # ##    #       #   #      # #    #   #        #   ##                    #  #    #         ## #   # #     # #  ##       #    #    # ####
 # # #      #  # ## ##   ##  #  ###  ####       #                    #  #      ## ### #    #  #          # #### ##     #    # #       # ##  ##     ##           ##
#       ##  # ###   ##   ##      ##            #   ##  # #       ## ##  #   # #      ### #      # #    #        #      #    #    #     #    ##      # ###### ##   
  #      #  #       # #    # #         #      ##          #            #  ###      #  #####   # ###   # ##     ## #     #  #   #    #         #   #      #  #    #
###   # #      #   ###  ### ##   #  ##  # #      #  #    ##      #     #     ###        ##      ##     #        #   ##  #   #      #   ##         # # #   # #     
  # #       # # #  #     ### #         #    #     ####     #      #     #    # # #  ####    ##   #  ##   ##  #     #   ##     ###     ###  ####     ###    #  # ##
  #   #   #    #   # #    #     #     # ##      # #     ## #         #     #     #     # #   ##   ## #    #  #####  #       ## #        # #    ##   #  ##      ## 
 # ### ## #    #      ## #     ## #    #    # ##    ###  #          # #   #  #    ###    # #####       ## #   # ##       # ###  #  ##     ##   ### # # ## #   #   
 #   #        #   ##        # ##       ##  #  # #   ###       ###      #  # ###  #        #     ##  #  #    ##  #         #   # #  #    # #     ### ####  ##    # 
##  #             #  # # #   # ##      #     # #     #  # #     #   ### #          ##  # # ##    ##      # ##    #  # #  ##         ##   ##     # #    ## # ##  # 
   # #  ##   #      ##  # #  # #  #   #  #    ###     ##  ##       ##  #   #      # #  ##   ##      #  # #    #    ##    ###   #  ##    # #      #### # #    #    
 ##   #    ###      #     # #    #       #        # #   ##   ##      #         #   #  # ####  #   ##  #     #   ##       #     #    ### #   #  ## #     #     #   
#   ####  ## #      #    # #      #    #    ###    ##  ###     #   ##    #   #          # #   #  #   ###   #   # # ###   # # #  #    #### ####   #   #  # ##   # #
       #    #  # #         #     #  ##       # #     ##    #    #  # #    # #    #  ###    #         #               # # #   #   ## ##  #  #    ###    #  #       
 ##       ###       ## #       ## #   # #     #   # # #    #    # # # #        #  #         ####     # ## #        #  #  #    #   ##     ##         #   #        #
   #   #   ##    ## #  # #      ##            ## ## ####      ##      #  ##       ## # ### # # # #  #      #    ## ##    ## ###   ##   ## # #  #     # #         #
       # ##   # #  #      ##  #    ##   #     # ##            ## ##   #   ##  # #  #  ###  # # ##   #  #           # #        #       ##  #    ##     #     ##  ##
  #   #  ## ##   #   ##   #       ## #   #        #     ###      ## ##   #      #   ###  #    #  # #  # ##      #       #    # #    #   #  #    #  #    #       # 
   # ## ##   ###  #      ##  #   ### #  # # # #    #     #     ## #  #        #     #   # # #  #   ##      ###       # # #              # #   ###      ###  #   ##
   # ##   ## #     #   ###  # #     #  #     ##   ## ### # #  ##   #   #  #  #             #        ####  #  #   #   ## #  #       # ##  #  #     # ####       #  
 # #### # #     #   #   ###  #   ##     # #     # ##       #    #       ## # #  ##  #   #  # # ##     ## #      #  #  # # ## #    # #  # ##    #     ## #  #    # 
  # ##  #    ## #  ## ##        ### # ##  #      #      #   ##  # ##  ##   #     ##   #     ## ##   #   # #      #  # #  #   ###   #     #     ##  ##  #  #  #    
 #  # ##  ###    # ###  #   ##     ##   #          #   #   # ##      #  ##    #   # #        # # # ##    #      #     ##   #       #  #    #    # #      #   #### 
##     # #  ##   #####    #   # #  # #  # ##   #   # ##  # #      #    #  #      ##  #  #  # #  ##         #  #####    # ## ##   #    # #  #    #  # #  ##     #  
    ###      #  #     #  # #   # #     #       #  ##  #  ##    # ### #  #   # ### # # # ###  # #   # #  ##  ##     #      #      #    ##   # # ## #     #   ##   #
 #  #   # # #              #      ##     ###   ### # #        ### ## # ###    ## ####       #    ###        #     #   #  #  # #  # #### ##   # # #  # #     # #   
      ##    #  ## # #  ####   #  #  #      #  #       #   #     #       # #   #  ##      #   # #  #  #   ###      ###    ###        #   #    ##  #    #    #   ###
 #   #  ##   # ## ## #   #        #    ##  #     ##  #    #   # #  #            #    #         #     #  #         #     ##   #  #    #   #           #  # #      #
 # #  ##   #    ##         #   #  # ####   #  ##     #     # ##  #   ##    # ##  ## #   #    ##  # #  #     #       #        # ##   #    #    ##       ##   ##    
   #  #  #  #  #####  #      ##         #    #          #  ###  #         #   #         # #     #  #  ##   #   #  #    # # #  #  #    #  # #   ## #         ##   #
#   #   #  #   #    #    ##   #       #   #      ### ##  #  # ##   #   #   #  # # #   #      # #      #      # #    #        ###   ## #  ###  ###   #    #       #
   #      # #         ###      # # #######   # #####   #   #      ###  #    # # ##       ##  #   # #     # # # # # #     #    # #   #    # ##       ###    # # ###
      #   #  ##   ##  ###       ## #  ##      #      ##                        #    #     ##   ##    #  ##  ##      #  #   #         ###        # # ##    # ## #  
  ##  #        #      #    # #      # #   ### #   # #    #     #    #     #  #      #  #      #  ##   #  #         ###       #   # #    ##  #    # #  ##   ###   #
###  ##   ## #    # #   #  #    #     # #        ###### #     #   #  ### ###  ####     #               ##  ##  #  #    ## ## # #  ##    # ##  #  # # ##   #   ### 
    #  # #  #    #   ##    ###     ##   #        #   ###      # ##    ##     #    ###        #  #  # #   #    ##    # #      #  ## ##  #     #  ##  # #  ## # ####
 ## ##      #   ####      #             #           # ##  #   # ###   #      #          #           #  #            #    #   #    # #   ##  # #      #    ## #   #
 #   ## #     # #     # ##   #     #    # #     ##  #   ## #  ##  #            #    # # #    #   # ##   #  #  # #  #    ## #  #   ## #      #     # #   # ## #  # 
   ##  #        ##  #   #  #   #   ##   ## #   #  ###    #     ##  # #    #    #     # # #  #       # ##      ######     ###    ####   #     ## #    ### ###   ## 
     # #   # #  # ###   ##    ## #   #    #       # ##        ### ##   #    #   # #   # ##   #   #  ### #   #  ####   #  ###     #  ## # #    # ###  #         # #
       #   # # #         #     # #       # ##  #     #  #    #       #      ####   #   #          #  #   #      #      ######      #  #   #   #  #     #    # ##  
#        #   #              ###    #   #  #  #####      #    ##       #  #   ## # ###   ##  #  #        # ####       #   #       #       #      ##              ##
    #   ###       #      #      # # ##  ##  #       ### #   #   ## #   #   ####      ####  #       #        #   #     #        ##    #  # ##       ###     ## #  #
   ##  ##  # #       #  #  # #      # # ##    # #    #   #   #             #     # #         ## #  ####      #  #   # # ## ## # ####              #      #  # ### 
   # # #  #      ## #  #  # # # #   #  #  #               # ###   ## # #    #      ##   ###  #  #       ## #  ##      #   #      #         ## ### #      # #  # ##
          # # #     #     ## # ##      # ##    #       ##  #  ##      #   # #   #  #   # #      # # #     #    #  #      #           ##   #      ##    #   ##  #  
#       # ##  # #        # # #         #         #   # # ##     #       ##  #  #   ####     #        # # #  #    ### ##    #   #    #####    #   # #  #  # ###    
  #       #   ###    ## # ###  # #            #   #  #    #    ## #     #   # #  # #        #  #  ####         ##   ##          #     ##  #  #   ###   ##  # #   #
     #### #  # ###    # #   #   ## #    #         #    ##           #     #       # # #         ##   # #  #    #     ##  ####     #    ###  ##    #  #   #  ##    
##        #      #  #   #  #   ##    #  #####  #    #       #  # #   ## ### ##     # # #     # # # #    #   ###  # #  ##  #  #      #     #  #   ### ###   #    # 
 ###   #  # #    #             #   # #  #  #  #  # #   #  #       ##  ##       # # # ##       #     #         ###   #    # #           #         #         ####   
  #    ## ##  ## #  ### #    #     #   #  #  # ##   #     # ##      ##  #     # # ## ##     # #             ##   # #       #   ##   # ## #  # ##   ##  ####    #  
 # #     #   #   #  # #  #  ##  # #  #   # #  #            ###  #    # #   # # # ###    ###    #  # #   ##       ## ### ##  #  ##     # #   #  ###  # #  #   # #  
       # ###       #   # #       ##   # #   #          #  # #   ##   # #    #  #####    #  # # #   #              #   # ##  #   #      ##   #         ##   ###  ##
     ##        ##          #  #     #    # #    #    ###     #   ##     #    #   #         ## ### #  #          ##   #   #   #  ##   ##     # #       # # # #     
##          # #    #   #   #      ###   #       #     #   ##   #      #  # #     #        #           # ### #   # #   ##      #  #   #  # ###   #      ##         
     # # ### #    ## #    #              # #   ##     #   #   ## #  # #   #  # #     #   #        #       #      ## #       ##  #  # #### #   ##     #  ####  # # 
    ##   ## ## # #    # #       #  ##        #    ##    ##   # ## #              # # #       ##   #  ##  #    #  #    #   ##   # #  #    ##        #    #  ###    
     ## #   #      ## #  # ###   ##     ###    #   # ##        ##  #    #    #   #    ## #    #    # ####   ##  #        ###       ### #     #  # ###  ##  #     #
     # ## #    #   # #   # #  ## #    # #            #   #  #  #   #     ##  #   #  #  #      # #  # ##  ##  #  #       #      #        # #  #  ###    #       #  
  #  # ###  # #  # #    ##     #           # ## ## ## ###  ##  #  #  #  # ## # ##  #   #      ##   ##   ##      #     #     #    #   ## #    #  ##           ##  #
    ###          #     # ####       #   #  #     # #  #  #      # #         #  #  #  # # #  # ##  #    ##   #  #  ##  #  #      ##    #     # ##      # #  #   #  
  # #### #  # # #          ##      ##   #   # # #  #    ###      # # # #   # # # #      #          #       # ##  #   #  ##       #      # #        #   ##    #  # 
  # ##       #     # #    #  # #   ##  ##    ####   #     ##  #  #   ##  ##       #      # #  # ##             # #  ## #  # ## #      ##     # #       #  #  #   #
# ###  ####  ## #   # ###  ###  # #  #         #          #    #      # #        ### #       #  ##   ##### #      ## # ##  # #    ## ##     #           ##  #  #  
     ## ## # ###  ###  ## #        ######  #  #   ## #       # ##       #    ##  #    # #    #   ##  #         # ## ##  # # #        #  #  #  #              # #  
     #### #   ##     #    ### #                  # #   ## #      #   #    #  # #    ##    #                 #    # #     #       #   ##  ## # #  ##  # #     #####
 ##          #   #    # #  #    # #      #   #   #  #   #     # #   #       #   # #    # # ## #  # ##     ##     #    ##  #  ##     # # #     ##    #  # # # #   #
 ##  ##  # ## # ### #            # #             #    ###   # #       #  #   #   # #        #  ## #    E###    ### # ### ##      ### #  #  #                ##    
 ###   #  ##    # ##  #  #  ##    #      ####   ##   # # #       #     ##      # # #  # ##    ## #    #      ##    # ## ##   # #    #       # #  # #     # #   ###
####    #     # #  # ## ###   #   ##   # # # # #   ##          #      #    #  #                #  ##  #  ##  #    #   ##   #     #     ##       #      #    # #  #
# ##    #     #          ###    #  # #   #       #   ##  ## #  #    #       #    ####         ##   ## # ##      # ##    #      ##  ##   # # #  #  #     # # # ##  
            #     ##  #        # ## #       #  #  ##   ##   #  #     #  # #      # ###    #   #     #    #     #    ###      #  #    # #   #  # ##   #     #   # #
         # #  #   #   #  #    #  # # ##     #      #     ####  ###  #           #    #  #   #  # # #     # #      ## # #      #   #     # #   ## #  #  ##       # 
   # #  ####   ###    #    ##      ### #     # #  #    #       # # #   ##    #   #  # #      ##    #  #   # #  ## # ## # #  #  #  ##   # ###  #   ##    #  #  #   
        #    #        #      ##  # ###   #  # # ##  #   #  #   #  ## ##  #                   #   #   # #    #    #  #   #        #       ####         #         # 
 #   #    #  ##  #     # #           ## ##           ##     #     #    #   # #       #####    ##      #  ####    #       ##   ####   #    ##   #                # 
 #         #  # #    ###   ##  ### #  # #     #   ## #   #    ## ##   #      # ###  #    ##      #     #    ###   #    ###   ###     #     ###       ##   #       
#       # # # # ##    #  ##  #   ###    #    #  #         ## ###  #     #        #   #  #   #      ##     # ##       ##   #   #   #       # # # ## # #   # # ##   
###       #   #    #     ## #      # # ##  # # #   #    ### #    # # ##   # #    #      ## #  #      # # #      ##  #      ##  ##   #   #  ###   #    #  #     ## 
###    # ##    ###   #      #  ##     #     ##       #    #       #  ## # ##        ##   #      ###            ##  #      ##     ###  ##  ##    ### #    ### #    
   # # #  # # #     #   #   # ##   # #   ###  # #            #    #     #    #   # #       #  #  #  # #  # #  #    ## #  #   #  ##           # ## # ## #  ##  # ##
   # #   ### ##     ##        #    #  ## # #         ##  # #              ## #    #    #  ##  #    ###     # # # # # ##   #      ##  ##     #      # #    ##      
  #  # #       # ##     #   # ##      #    ####   # # #       ##  # ## #      ##       #  #     #    #     #    ##   #         #          #    #         #  #     
    #  ##  # #    #   ##       ## #    #   #        #     #     #  #       #   #  ## #    #   # ## #   #        ##   #### # #  #     #  #       #         #   #   
  #   #    # #        ##  #  #      #   #####    #             # #  #   #  ##### #   # #  #       #         #   #   ##       ###    #    #              # ##  ##  
 #  # ##   ## #   #   #   ## #  # # ###  #      #     #  ####  #          ##  #           ##     # ## # #   ## ##   #   # ## #    #   # ##  #   # ##  #  #   #    
  #  #   #  ## # #                  # # #  ## # # ###      #           ##  ##  # #    #     ##        #  # ##      #    # ##  #   ##  #     # ### #       # #  # #
    # # ## # ## #              ##  ##    #     #  # ##  #  #   #### #     # # #### #  #  #   # #         #        ## #   #   #  ### # ##  # #   #     #     ##    
 #   # #   #     ### # ###   # ##   #   #  #  ##   #     ## ## ## ##     ##   #    # #  #  #   ##   # #  #  # #   ## #  ###   ##        #  # #    ##   ##   #     
#              #  #     # # ##   # ## # # #    # ## #        #     #     ### #       # ##  #### ### ####   ## ##    #        # #    #  ## #   ###     ##        ##
  # # ##  ##       #       #         ##    ## # ### # # ## # # # #      #     ###       #   #     #    ####    # ##   # #          ##  ##   #   #    #       #    
 #         #  #  ##   # #     # #    ## #    #       #    #  ##    # #    #     ## ##  #  # # #    # ###    ##   #          ####      #  # #  #             #    #
  #  # #   ### # # # #     #       ###  ##   # ## # # #          ### # #   # # ##   ##  #  ## ## #   ## # # #    #        ## ### # #   #         # # #  #         
####  #     # #     # #    # #  #  #    # ##  ##    # ####     ##    # #      ##    ##   ##       #    #    #          # #     # ## #    #         # #        ### 
  ##        #         ###     ##       #  ## #  #   #  #    ####     ##    # ###  #  #   #      ##    #   #  # #   # ### #      #      ## ## #    # #   #   #  #  
         ## #       #  ## ##  #     #####        #### # # # # #  #     #     #    ##    ###     ### #    ###               # ##  # ## ###   #       ##            
   # # ## #       #  # #       ##        #  #   # ##  #  # #    ###    ###           #  ##  #    ## # #  # #      ##      ##      #  #### ### #     #          ## 
    #  #    #   #   ##  #  ####     #   ##    ##          # #   #  ###      # #  #  #    # ##  #    #  ###  #### ### # # ## # ##   #  ## #  #   #   ###    # ###  
     ### ## # ###  # #  #      #  #    # # # # #     #      #   ##         ## ##   #    ##   #    #    #   ##  #        # ##     # ## # ##  #         ##   #      
        # # #   #         #  ##   #    #             ####   #      #   #    # #   ##  ##             #   #    #   #  #  #   ##    ##   #     ##### #   ##   # #   
# #   # # # #   #    ##            #   # # #  # #### # # #    # #   ## # #   #  #    ##  ## #  ####   #    # ## # #  ## ##  ###  ##        # #  # ###  ## #       
                ##        #  ##  #   # # ##   # ### # # #   # # ## #  ###       # #    #   ### # ### #  #  #### #  #   ##   #  ###  #  #     ##     ##    ##  # ##
#  # #  #  ####      #  # #      ###     #     #  ## # #  #     #   #    # ## #    # ### # ##        #   # #   ## #      # #   #     #   # ##### # # ##   # #     
     #    #    #   #    ## #          #  #   #  ## #  ##    # ##        # #         #   #    #  # #    ##   #   #   # # #    #    #  # # #     ##     #  #   ##  #
  ##      #               ##     # ##     ##    #   #    ##   #  #     #       ## # ### ####        # #       #     ##    #    # # ##  # ####    # #          # ##
# #    # ####   ##     ##  # # #     #        #      #      # ##      #     #        #   #   ## #       #  # #   ## ##          #  #  # # #      #  ##       # #  
  ###     #  #    #  #    #    #    ## ##       ##### ##  #### #  # #         #         #  #          #  #   # #         ###### #      # #   #    #  ##        ## 
     #             # ## ## ##   #   # ###        #     # # # # #      ## ### ###          #    #   #   #    # #   #     # ## #   ##  ### #  # ##     ##     ##   #
  # #    #     ##     #     #      # #  #   ##   #    #     # ##  #    # #    #     # #  #  #       ##  ###   ##    #  # # #      ####   # ## # #      ## ### #  #
#    #    ##  #       ## #     ##      # #  # #  ### #        #  #   # # #  #          ## # #    #    ##           ## ##  ##     ##                   # #      # #
#  ##    # ##         #        #    #  ## #####    #  #     #      #  # ###    #       #  #   # #         #                   ##     # #          ###  # #   #  # 
##  #  #   ####         #    #  # ###       #      #  ## # # ##         ### #       ## # #   # ##  #    ##   ##    # #      ##  #  #   # #    #      #  #  #    ##
  ##      ##  # #  #           #     #      #  ##       ###   #  #    # ##     # #   ## ##  ####   ###    #   ###    #     # ##  #   # #  # #   #  ####      ##  #
#    #    #   ##   #    ###       # # # # # ##      ###              # #  # # #   #    # ##  #   ##               ###  #  ###          #  ### # # ## #        #   
        ###      ### # # #     #    #  ## # ###       #            ##  #    # #  # #      #    ## #     # # ###       # #    # ## #     #    ## #      #   #      
 #       ## # #    ###    # # #  ## ##   #     ## # #  #         # #      #  ##     #  ##              ## ##  #     #  # # #   #  #    #  #  #  #  ####       ##  
      #       ##  #  ##             # #  ## # # # # ###  #         #           ##  #  ##  # # # #     ##   #  #     # #  # # ##  # #   #       #     #  ##  ## #  
     ##    ## #           #   #       #       #  ###  #  ##  ##   # ## #  # # # #  #    #   #   ##      #      #        ###  ##    ## # #    # ##     # #  ###    
      ## #  # ## #   #        #  #           #        #   ###   #### ####   ####     # ##      ##   #    #   ###    #     ## # # #  #    # # # #                  
#  # #       ## # ### #     # #  # ##      #            #  #   #     ##     # ##   #             # ### #      # #  #     #  #     #   # # ##         # #       #  
#                    # # ####    #            #  #    #        #   #  #  #     ##  #  ## ##  # #     # ##   #   ##          #      # ##  ##      ##   #  #     #  
 #  # # # #   ##  #   ## ##     ##  ##              # #  #  #  #     # #  #    #   # ###       # #  #    #  #                       # # #         #  #  ##  #   # 
 # # # #  #    # ##    ##          #   #  #   #      ##  #       ###  # #    ##   #     #  ## ### # ##### ###      ##  #### #    ##    #  # ## #  # #  #   #      
##    ###    #        # ##  # ##    #          ####      # ##    #         ##    ##         #        #   #  # # ## #  # #    ##    ## ##                 #   #  # 
   #    #    #   ##     #   #   #       #   #       ### ###       # ##  #    #    #  ###      # # #  ##      # #      ###   # #    #  #   # #   # #   #         # 
# #       ## #              # # #  #    #       # ###    #    #  #     ##   # #  # ##    # #         # #    #  ## # #  #       ## #    #      ##  #  #     #    ##
      #   #   ##  # # ##  #    #       #     #  ###  #   #  #  #    # #    #   ##    ###  # #   ##      #   ###   #    # ##     ##      #  ### ## ##    ##       #
 #    #  ##    #### ## #     # #  #       #  #   # ##        #    # #    #   ##   # # ##  ##   # # ##      ###       ##   #    #  ##        #       #  #     # ## 
# ##      ## # #      #   #    ##  #              #            #       # #   # #     # #      #   #   #  # #  # ##  #           #       # #    ###    ##  ## #    
 #  #  ## # #     ## # # #   #   #    ##   #  ###  #  #  # #   #      #       #        #### ##     ##   ##       #### ## #  ##     #                     #   #  # 
     #   #  # ## ##    #          # ##     #  #  ###  #  #      #      #   #   ##   # ##   ##    ##      #     ##   ##       #     ##              # #  # # ###  #
 #   #        ##    #  #  #    # #    ##      #    ## #  ##    #  ##   #   #  # #  #             #    #    # # # ##  ##     ##  ##     # #  #      # ##  ## #  #  
##      ##  # ##       #   ## ###  #     # #      # #   ##       # #      # #      ## # ###  #  ###   ##  #  # #    #       #  #  ###     ##         #       ##   
  #     ## # # #   # #  ## #     #     ##  #          ###     # # #        #  #  # # ## #       #   # ##   ###   # #  #          #   #  #     #   ###  ## #  #   #
#   #   #      #  #           #        ##  #  # #  #  # ## ##  # #  #       #  #  # #       #  # ##  #    ###  #   #  # #       # #   # # ## # ## ###       # #   
       ###   #  #     ####     #   ##           #    #    # # ### ##      ###      ##    ### #              ###   #    ### ####     # #      ## #  #  ####    ##  
     #   #  #  # #   ##       # #     #   ## ##          #  ###      #    ##   #    #   #      #    #   #  #   #   #  ##    #         #  #  ##  #  # #  #        #
  # # ## #    #   ### #   # #    #   ###   #   # # #  ##  #        # #  #  # #    #        # #   ##  #         ### ## # #   # # ## #   #     #       ##     ###   
    #             #         ##     #          ## #      #      # #  ## #           ##    #     #   # ## #   # #       #  ####   #    #   #  ##    ##   #  #       
# ##  #      #   ####     # #  # # ### # # #     #  #    #     ##    ##   #   ###               ##    #    ##  #  # #  ### ##   ## #  #    #    #    ##  #  #   # 
# # # #  #  #              ##   #### # #   # #       #    # #    #          #   #  #  # #       #     # # #  # ##  ### #          ##      ##     #     #      # # 
 #        # #        #    ##   #    # ###  ### # #     ##         #  ## ####   #   #    #  #  #  #  ####       #  ##  ##     # ##     # #         #   ###  #  # ##
 ##  ##    ##       ## ## ##          ## ##  #       # ## #           #  #      # #     #   # #  # # ## ##     #  #   #      #   # #  ##   ##     #    #  #      #
 ##       ##     ###     ### ###### #      ###     # #    # # ##  #   #    ##   #   # #  # #  # # ## # #   # #   ###   #  ###    ##     #         ##       #   # #
####        ##   ## #  #    #   # #    #  #     ##      ###   ##  ## #       #   #    ## # #    #  # # #      ##   #   #      # # ### #      #      #     #      #
#    #    # #   #### #   #    #   ##    # ##  # # #    #    #      #  #    #         ###  #    ##   ##   # # # #         ##         # # # #     ##     ## #  ##   
#  ##    # # #   #   #     ## # ##      ##       #  # #   ## #  #  ###  #  ###         # # ##     #  # #  #  #   #     ##      ### #   ## #    #         ##  #    
# # # # #   # #     ### # #       #   # # #  #    #      ## ##   ####        ##    #   #  # # # #  # #        ##   # #  #  #  #   ###      # #  ##  #    # ## ##  
   #    ## ## #            #            #    ###     #         #    ##  # #  #  #    # # ##   #  #    #     # #         # #  ### # #     #    ##   # #       ## ##
 #  #        #   #   ####  # ##   ##  ## ## #                  #    # ## ##     # ##       #      #    ##  #  #  # # #  # ####    # #  ##      #      #   #  ## ##
## ##  ####    ##    ##    #  ## #  #  ####   #   # # #       #     #  #   ##       #  #  #     # #         ##     # ##    # # # #     ###### #   #       ## ##   
          # #    #     # #            #  #  #        # ###  #   ##   #   #  # ###   #      #   ###  #   #   #    # # #   ##   #   #          #   #   # # #        
  ##   #  # #    #   #   #  # ##  ##    #   #    #    ###  ##  # ##          #     ##   #       #      # #    #  #   #   # ##     # ## # ## #        #            
   #  #  # #   #     # ##        # #    # #  # ##        #     # ##          # ##   #  ## # #         # #   ###  #  #  # # #    # #       #  #  #  #  #  #   #    
#     ### # #        ##        #    ##    #   #  #    #  ##  #  #   # ## ##    ##      #     ##            #  #      ## ##        ##     ##         #     ##    ##
