           #        
#S #        #       
# ######    # #     
      ## #    #    #
    #        ###    
#       # ###   #  #
   #    # #     #   
   # #  #### # #    
  #   #         #  #
  #           # ##  
 #  #   ##    #     
#    # #      #     
  #       ##    #   
    ###   #  # #  #
#  ##      ##  # # #
      #    ##       
##    ###        ## 
# #      ###      # 
      # #    ##   # 
 ### #     #  ## # #
     #    ##  # ##  
#  #    #   #  # #  
    #    # ## #     
  # # ##   #   ### #
## #######  ### #  
  # #    ##   # # # 
##   #   ###    #   
 ##  ##             
#  #### #    #  #   
#  # #   #   #     #
   #  ##  #    #    
##       ##### #### 
  #      # #    #   
#      #     #      
   #  # #    ##   ##
 ###### #  ##  #    
  ####     #  # #  #
    ##             #
####   ## #  #   #  
 #  #      ## #     
    #         #  # #
   #### # # #     # 
 #    ##        #  #
# #           # # # 
    #    #### # #   
 ### # #   #### # ##
# ### # #  #  ##   #
  # #  #       #  # 
  # ##  E           
 # ###    ## ### # #
     #        #   # 
  ##   # ##  ##   # 
#  ###  # #  #      
