  ##  # #     #     #   # #    ##     # ##  #             # ####
 S## ##  #   #   # #       # #    ## #  #  ### ###     ## ##  ##
    #  #  #     ##    ##  #    # ##  ## ##### ###   # #  # ## # 
# #  #  #    #       #      #   # #       ## #     # #    #  #  
  #     #  #   #    #       ### #   # # #     #  ## #  #   #   #
#   #    # ##     ###  ##  #  #  #  #    # #   ##            #  
          #   #  # #  # #  # #    #     ##       # #    ##  ##  
##  ## # # ## #  #   ##    ##      #   # #      #    ###        
    #      ##  #  ### ####     #  #     ### ##     # # ##     # 
 # #    #     # #        # # ##  #    #              ##    ##   
    #   ###  ##          ##  ####     # #        #       #  ###
# #  ##    ###          # #     ## # #  #       # #  ####       
      #  # # #   #     #       #        ##     #     ##  ####   
    #              #    ## #  #   #       #    #  #  #      #   
   #  #     #  #     # # #   #                # # # # ##    ##  
#  # #   #   ##  #      ##         ### ##           ####   ##   
      #  #    #   # #    ##    ##  ## #  ##     #  #    #  # ## 
  # ## # #  #  #   ##   #    ### #  #    # ###     ## #  #  #   
#  #       #   #   #   # #      #  ##  #   #  #         #  # ##
# ##  # ##   # #                   #  #  #    ##  ##      #  #  
 ###  #  #         # #   # # ###        #  #  ###    #  #    # #
###               ##   ##   #     # ##    # # ### # # ###      
 ## #       #    ##  ### #     # #    #     # # # #            #
#   #           #   ## #       # # #  #     #   ###            
 #   #### #        #      ###   #   #           #  # #     ##   
##   ##  #      #     #      #    #   ##  #     #   #  ##   #   
 # #  #      ##          #  #  # ##        # #       ###  ####  
   # #  ##  #### # #      ####          # # #       #          #
#        #    #   # ### #      # #  # #   #  ####   ###       # 
   #  #    #   ##  # #         # #    # #   ###     ##    ## #  
      #     ##    # #  ###      #  #      # #     # #  # #  #   
#  #  ##  # # #   #   #  #     # ##     #   #   ###       #     
      #  # #  # ###    #  ##  #   ##    ##   #  ### #        ## 
# ## ## #    #   ##   #  ##        #   #    ## #     ##   #     
    #     #        ## #   ##  #  ##  #  ##  ##   # ##    #    # 
      #        ##  ##     #  #      # #      ## #   ##        ##
  #  #  #      #   ###  ##               # #       # #       ## 
#     ###      ##  #  ## #   # #   #  ##    ## ##    ###   #    
#       #         # #  #  #  # # # #      ##      #     ##  # # 
#  ##         ## #       ## #           #   # # #  #  ## # # #  
 #     # #  #  # # # #  # #     # #   #     #        #    #    
   ####    #       #  # ## # # # #    # #     #       #     ####
   ## #     #  #     #   ##   #      #  #  ## ### #             
   ###   # #      # #   #     #  ### # # ###      ##  # # #     
#      ###  # #          # #  #       #     ## ## #     ## #    
 #  ###   #  ##  #  ##        # #     #             ## #  # ### 
 ##  #     #    ## ##     # ## #    ##       # # # #     #### # 
#  #    #    # # #    #  # ## ## # # #     #  #  #    ##   # # 
    #  #  #  #    # #  #  # ##   #        # ## # ###  #  # ###  
   ### ##   ##     # #    #   ##    ### ##   # #    # #  #  # ##
     # # # # #   #### # #    #  #   #     ###             # #   
#   # #        ####  #     # #   # ##      #   # # # ##      # #
# ###     #  p #  #                     # ##    #####    #  # #  
#                ##   ##      # # ####  #    #      # #   ##  # 
     #           #  #     #  #    #  #   #             #     #  
#  ##  #  #    ##   #    #   #       #     # #  # # ##   #   ## 
   # #    #   #      ##  #  #    #     #  #   #  # #      #   ##
  ####  ####     ##       #  # ##   #  #   ###   #   ##   #     
  #   # # #   #       ##   #     #  ###    ##   #  #   #  #  ## 
 # ## #      #  #     ##  #  # #       #  #       #      #     #
    ## ##   ##    #  ##    #    #     #   #   # ## # #  #     ##
  ###    #  ### #   #    #   #   ##      ##   #               # 
 #         ### ##  ## ###  # #  #  ## ##         # # #   # ## # 
# ##     #     ##  # #  # #    ##  #  #    #     ###           #
  ### #   #    ## # ##      # #  #    #    #### #   #     #   ##
   #   # #      ####    ###  ###    #  ### # ##        # # #    
#  ### # #  ###  # # #   #           #    #      #     ## # ##  
 # #  ## #      #   # #   #        # ##    ##  # #         ##   
        #                 ##   #   ### #     # #  #  E ##    # #
 ###           #  ## # #   #            # # # #    #     ###    
  # #   #    #    ##  #    ##  #      # #####    #              
 ##         #   #   ### # #   # #      # # #  #        ### #  # 
##         # ##      ##   ##   #   #   #   #     #       #    # 
     #    #    ####   #     # ###   ##  #  ## #     ##  #  #  # 
 #  #   ##  ##      #   #    #   ##   # #       # #  ##   #     
 #    #   # ##            # #   #    ##   ##     ## #           
 #  #       #   #   #           # #   #      # # # #     # ##   
## # #     #  #  ##     #   #        #    # #             #     
  # ##    # ##   ## ### #          ## # #        ## ###  #     #
  #   #    # #        #        # # #      #  #    #             
          ##   #   #  ##     #          #   ###   #         #  #
 #  # #      #        # ##    #    #  #   #   #          #  #   
## # ### # # #        #    #    ## # ## #  #  #       ### #    #
 # ### # #            ##    ##      #     #       ## #  #   # # 
  # #   # #                 #  #        ## ###            # #  #
 #     #    # #     #   #   #      #  ##  #   ##          # # # 
  ##            # #    #     #   #      ## #        #    ### #  
#   #       #    #  #  # #      # #                   ## # #####
##      #   #           #    # # #    ##  # # # # # ### #   #   
# #       ## # #  #       ##   #     #  #      #   ##   #  #### 
#  #  #         ####     ####     #  #     #  #    ### # #     #
      ##  # #  ## ##  ## #   # #   #  # # #   #   # # ####      
  ##  # ### #  #       ##     ##        # #   #      #       #  
            #    # #     #    #   # #    #      ##  ###  # #    
## #  # ##    # # #    # # # ##   ## #  ##  # #       #     #   
  ##   ## #     ## #      ###  #    #            ##     #   ####
     #   #   #      # ## #     # ##    #     #  ##   # ###      
      # #  ## #  #         ##      #   #      #  ##    #  #    #
#     # # # #    # ## ## ##       ##  ##### ##      # # ###     
   #  # # #       #  #   #      #  # #   # ### #   ## ## # ##   
  # #    # #  # #  ##  #   #  ##           #        #    #  #   
  #  #  #          ##  #   # #   #  # #     #  ##   #  ## ## # #
#    # #    #      ### #   ##   ### #   #  ##   #      ####  #  
# ##    ##      ## #    #   ##  #  ###   #   ##  #  #      ##  #
  #   # #  #      #    ### # #  #  ### ##        #   ##    #   #
### ##     # #  #     #  ##  ## ## #  #      #       #      #   
##### # ####   # ###  #    # ##    #   #     ## #   #### ##  ###
  #  ##  #   #      #        #      #       #    #  # ###      #
   #    ##  #     #  # ## ###    ## #  #  # #  # ## ##      #   
  # ##    ## # #                 ## #  #   #    #              #
  ## ## ###      ###   #  # ##  #             # # ###      # # #
#  ###    # ##   #                 #       #   #     # #     #  
 #      # # ## ##       ##    # #    ##      #      ##    ### # 
#     #         #   #    #   ##    #      #   # ##        ##    
       ## # #  #      ##      #   #  #  ##    ##   #    ###   # 
 #     ## # #  #           #   ## #     #          ###     #  # 
   # # ##          #       #             # #     # #   #  ##   #
   ##              ##    # #  ## #           # #    ## ##  ##   
#        #    #  #  #    #  #     #     ###  #   # #  #         
#      #     #      #### #   ##  #  ##    #       #   #      #  
   # ##   # #   ##     # #  #  # ## # #  ##  # #       # ##  #  
#####   # # ##  ###                 # #   ###       # # #    #  
 # #       # #  #              # ## #  ####        #  ### ##  # 
 ##    #       ## #  # # #   #  # #       # #  #            #   
 #     # #    #     #   #  #       #    ##        ##   #  #    #
## # ###   ##    ##   # ##  ## ####     #   ##     #   #        
